language,length,count_ones,count_zeros,ratio_ones,ratio_zeros,frequency_11,frequency_00,entropy,valeur
"['1110', '0', '1010', '000', '1100']",16,7,9,0.4375,0.5625,2,4,0.9886994082884974,0
['11011'],5,4,1,0.8,0.2,2,0,0.7219280948873623,1
"['000', '1100100', '01', '11']",14,6,8,0.4285714285714285,0.5714285714285714,2,3,0.9852281360342516,1
"['11', '10111']",7,6,1,0.8571428571428571,0.1428571428571428,2,0,0.5916727785823275,1
"['100', '1', '110000', '0110', '01000', '0', '1', '001', '01111', '11']",31,15,16,0.4838709677419355,0.5161290322580645,5,7,0.9992492479956564,0
"['0', '1101', '1001', '0']",10,5,5,0.5,0.5,2,1,1.0,1
"['111000', '110', '100100', '100110', '0000101', '1', '1100111']",36,18,18,0.5,0.5,6,7,1.0,1
"['11', '1100', '0011', '000010', '1010011', '10', '101011', '101', '01101', '01111']",44,25,19,0.5681818181818182,0.4318181818181818,8,5,0.9865446300055644,0
"['011111', '10101', '110010']",17,11,6,0.6470588235294118,0.3529411764705882,4,1,0.9366673818775626,1
"['010100', '1100', '1101011', '000', '00000', '110000']",31,11,20,0.3548387096774194,0.6451612903225806,4,8,0.9383153522334068,0
"['11111', '1100010']",12,8,4,0.6666666666666666,0.3333333333333333,3,1,0.9182958340544896,1
"['1000', '11001', '110110', '10']",17,9,8,0.5294117647058824,0.4705882352941176,3,2,0.9975025463691152,1
"['001', '1']",4,2,2,0.5,0.5,1,1,1.0,1
['01111'],5,4,1,0.8,0.2,2,0,0.7219280948873623,1
"['01', '01', '001010', '111', '0110101', '0']",21,11,10,0.5238095238095238,0.4761904761904761,2,1,0.998363672593813,0
"['1101', '0001', '10101', '11', '11111', '000']",23,14,9,0.6086956521739131,0.391304347826087,6,2,0.9656361333706098,0
"['110', '1010010', '0101', '01010', '1000001', '010', '1', '1111', '11011']",39,21,18,0.5384615384615384,0.4615384615384615,5,4,0.9957274520849256,0
"['01010', '110000', '0', '10', '0000110']",21,7,14,0.3333333333333333,0.6666666666666666,2,4,0.9182958340544896,0
"['101101', '1000111', '1001', '101', '011100', '0000100', '0100', '111']",40,20,20,0.5,0.5,7,7,1.0,0
"['011', '01110', '0', '00110', '111', '100']",20,11,9,0.55,0.45,5,3,0.9927744539878084,0
"['1', '10', '0100', '1001', '000']",14,5,9,0.3571428571428571,0.6428571428571429,1,4,0.9402859586706313,0
"['0010100', '1010001', '10000', '0', '0101111']",27,11,16,0.4074074074074074,0.5925925925925926,3,6,0.975119064940866,0
"['010', '10100', '110011', '0000', '1', '111', '1000', '0', '1']",28,13,15,0.4642857142857143,0.5357142857142857,4,6,0.996316519558962,0
"['1001', '1']",5,3,2,0.6,0.4,1,1,0.9709505944546686,1
"['1001010', '00101', '1', '10', '10110', '1100', '011', '1001111', '1', '101']",38,22,16,0.5789473684210527,0.4210526315789473,7,4,0.9819407868640976,0
"['00', '011001', '00011', '11110', '11']",20,11,9,0.55,0.45,5,3,0.9927744539878084,0
"['101', '0', '0110010']",11,5,6,0.4545454545454545,0.5454545454545454,1,2,0.9940302114769564,1
"['1', '001110', '11111', '11110', '001', '0111', '0011110', '01100', '1']",37,24,13,0.6486486486486487,0.3513513513513513,9,5,0.9352691398683566,0
"['101101', '01', '01', '101000', '1010111', '0', '1110', '1']",29,17,12,0.5862068965517241,0.4137931034482758,4,1,0.9784493292686188,0
"['0010010', '10111', '000001']",18,7,11,0.3888888888888889,0.6111111111111112,1,4,0.964078764808229,1
"['011', '000100', '0001110', '11', '1101', '100', '0']",26,12,14,0.4615384615384615,0.5384615384615384,5,4,0.9957274520849256,0
"['10001', '0100101', '1', '010', '00010', '101', '100111', '0']",31,14,17,0.4516129032258064,0.5483870967741935,3,5,0.9932338197397066,0
"['0', '01011', '111101']",12,8,4,0.6666666666666666,0.3333333333333333,3,1,0.9182958340544896,1
"['111100', '100', '1011', '0', '101', '110']",20,12,8,0.6,0.4,4,2,0.9709505944546686,0
"['1110', '11', '110', '11', '0110', '001', '011111']",24,17,7,0.7083333333333334,0.2916666666666667,7,1,0.8708644692353644,0
"['1', '010000', '101100', '0100', '0001100', '00', '101', '1111110', '11100', '00']",43,19,24,0.4418604651162791,0.5581395348837209,6,9,0.9902246902198684,0
['10000'],5,1,4,0.2,0.8,0,2,0.7219280948873623,1
"['1001', '1', '0']",6,3,3,0.5,0.5,1,1,1.0,0
"['1111', '01110', '01']",11,8,3,0.7272727272727273,0.2727272727272727,3,1,0.8453509366224364,1
"['1', '001100', '1101']",11,6,5,0.5454545454545454,0.4545454545454545,2,2,0.9940302114769564,1
"['1100', '0', '00', '101100', '001001', '000010', '1011110', '1110', '101']",39,18,21,0.4615384615384615,0.5384615384615384,5,7,0.9957274520849256,0
"['1110010', '110001', '100', '11010', '110001', '01001', '0', '00', '100011', '01010']",46,21,25,0.4565217391304347,0.5434782608695652,6,7,0.994538681650011,0
"['11', '111100', '0110101', '10110']",20,13,7,0.65,0.35,6,1,0.934068055375491,1
"['00001', '10001']",10,3,7,0.3,0.7,1,3,0.8812908992306927,1
"['00', '1', '10000']",8,2,6,0.25,0.75,1,3,0.8112781244591328,0
"['0010', '111', '1111', '100']",14,9,5,0.6428571428571429,0.3571428571428571,4,2,0.9402859586706313,0
"['001011', '110101', '010']",15,8,7,0.5333333333333333,0.4666666666666667,2,1,0.9967916319816366,1
"['0', '1', '1111111', '1000110', '101011', '1011111', '01', '011011', '110', '10']",42,29,13,0.6904761904761905,0.3095238095238095,11,1,0.8926230133850986,0
"['1011000', '1110', '1110', '11', '100', '00110', '01']",27,15,12,0.5555555555555556,0.4444444444444444,5,4,0.9910760598382222,1
"['100000', '00', '1001010', '1010100', '01100']",27,9,18,0.3333333333333333,0.6666666666666666,1,6,0.9182958340544896,1
"['001', '1001', '0011', '1000000', '0', '110001']",25,9,16,0.36,0.64,3,7,0.9426831892554922,0
"['000001', '100111', '01']",14,6,8,0.4285714285714285,0.5714285714285714,2,3,0.9852281360342516,1
"['01', '01111', '000110', '1101', '10']",19,11,8,0.5789473684210527,0.4210526315789473,5,1,0.9819407868640976,1
"['111001', '1000000', '10', '011', '1110']",22,11,11,0.5,0.5,4,5,1.0,0
"['1', '0110', '0111', '00', '011']",14,8,6,0.5714285714285714,0.4285714285714285,3,2,0.9852281360342516,0
"['1011110', '100', '0', '111', '0011']",18,11,7,0.6111111111111112,0.3888888888888889,4,2,0.964078764808229,0
"['10', '010001', '010', '1', '0', '0', '010', '1101000']",24,9,15,0.375,0.625,1,4,0.954434002924965,0
"['010110', '1', '0000', '000', '01', '1', '1000001', '10', '011101', '011101']",38,17,21,0.4473684210526316,0.5526315789473685,5,7,0.9919924034538556,0
"['111', '01', '01100', '1001', '111', '0']",18,11,7,0.6111111111111112,0.3888888888888889,4,2,0.964078764808229,0
"['0', '1101000', '0', '1', '01', '0000', '1', '1111', '0001010']",28,12,16,0.4285714285714285,0.5714285714285714,3,5,0.9852281360342516,0
"['0', '0', '11', '001111', '110011', '00', '101', '1011']",25,15,10,0.6,0.4,7,4,0.9709505944546686,0
"['100', '01', '011', '01011', '01', '1']",16,9,7,0.5625,0.4375,3,1,0.9886994082884974,0
"['100110', '0']",7,3,4,0.4285714285714285,0.5714285714285714,1,2,0.9852281360342516,1
"['0101', '00110', '11', '1111', '0011', '01000', '11101', '10100']",34,19,15,0.5588235294117647,0.4411764705882353,7,4,0.9899927915575186,0
"['0011010', '0', '0110010', '1101100', '1', '111']",26,14,12,0.5384615384615384,0.4615384615384615,6,4,0.9957274520849256,0
"['0111010', '0111011', '01111', '1111', '0', '00010', '1', '0']",31,19,12,0.6129032258064516,0.3870967741935484,7,3,0.9629004147713268,0
"['0100010', '0010100', '0101']",18,6,12,0.3333333333333333,0.6666666666666666,0,3,0.9182958340544896,1
"['0', '0', '010', '0100', '01', '1011010', '000', '101', '0000', '000001']",34,10,24,0.2941176470588235,0.7058823529411765,2,9,0.8739810481273578,0
"['110100', '100', '01', '11000', '110010', '0111', '0010', '1000100', '1110010']",44,20,24,0.4545454545454545,0.5454545454545454,5,9,0.9940302114769564,0
['101100'],6,3,3,0.5,0.5,1,1,1.0,1
"['0011', '1001010', '11101', '011', '00000', '10011', '1', '0', '10001']",36,17,19,0.4722222222222222,0.5277777777777778,4,6,0.997772472089982,0
"['0011', '10100', '01111', '000001', '0000', '0101', '0', '101']",32,13,19,0.40625,0.59375,3,6,0.9744894033980523,0
"['011', '111', '0100010', '11110', '0110000', '01110', '0110', '110']",37,20,17,0.5405405405405406,0.4594594594594595,8,5,0.9952525494396792,0
['10110'],5,3,2,0.6,0.4,1,0,0.9709505944546686,1
"['101001', '1']",7,4,3,0.5714285714285714,0.4285714285714285,1,1,0.9852281360342516,1
"['1001', '0101010', '1110000', '01', '0']",21,9,12,0.4285714285714285,0.5714285714285714,1,3,0.9852281360342516,0
"['010', '01', '10100', '0010100', '1']",18,7,11,0.3888888888888889,0.6111111111111112,1,4,0.964078764808229,0
"['010110', '11', '0', '001', '1001011']",19,10,9,0.5263157894736842,0.4736842105263157,4,2,0.9980008838722996,0
"['0', '01100', '1', '1011', '1']",12,7,5,0.5833333333333334,0.4166666666666667,3,2,0.9798687566511528,0
"['1101', '0110111', '0', '0', '111101', '01', '01', '0', '1', '000']",28,16,12,0.5714285714285714,0.4285714285714285,5,2,0.9852281360342516,0
"['010', '00', '001', '1010010', '0', '101', '0011010', '1011']",30,13,17,0.4333333333333333,0.5666666666666667,3,5,0.9871377743721864,0
['0011101'],7,4,3,0.5714285714285714,0.4285714285714285,1,1,0.9852281360342516,1
"['1', '0', '10111', '00', '1', '11100', '0010', '001010']",25,12,13,0.48,0.52,3,4,0.9988455359952018,0
"['100001', '01', '00101', '010', '000011', '0', '1111110', '1', '01', '1111000']",40,20,20,0.5,0.5,6,6,1.0,0
"['10100', '011001', '10', '100101', '0111010', '1', '0101010', '0']",35,17,18,0.4857142857142857,0.5142857142857142,3,4,0.9994110647387552,0
"['110010', '0']",7,3,4,0.4285714285714285,0.5714285714285714,1,2,0.9852281360342516,1
"['110', '0101111', '10', '1', '1']",14,10,4,0.7142857142857143,0.2857142857142857,4,1,0.863120568566631,0
"['1010101', '1', '0', '0101001', '01', '011101', '0000000', '0111', '000101']",41,18,23,0.4390243902439024,0.5609756097560976,3,7,0.9892452969285004,0
['1'],1,1,0,1.0,0.0,0,0,-0.0,1
"['1011010', '1', '01']",10,6,4,0.6,0.4,1,0,0.9709505944546686,0
"['0000', '0', '1100010', '000011', '0001000', '010001', '101111', '1001101']",44,17,27,0.3863636363636363,0.6136363636363636,6,10,0.9624127354629924,0
"['11110', '010']",8,5,3,0.625,0.375,2,1,0.954434002924965,1
"['1110110', '1110', '0011110', '111110', '1', '00000']",30,18,12,0.6,0.4,7,3,0.9709505944546686,0
"['010011', '1', '1', '010100', '01100', '000000']",25,9,16,0.36,0.64,3,6,0.9426831892554922,1
['110111'],6,5,1,0.8333333333333334,0.1666666666666666,2,0,0.6500224216483541,1
"['01', '110100', '00', '11100', '100110', '11001', '000010', '01', '1000', '001']",41,17,24,0.4146341463414634,0.5853658536585366,5,10,0.9788698505067784,0
"['0110011', '01011', '111000', '10000']",23,11,12,0.4782608695652174,0.5217391304347826,4,4,0.9986359641585718,1
"['1011', '0101110', '1110']",15,10,5,0.6666666666666666,0.3333333333333333,3,0,0.9182958340544896,1
"['100100', '011', '101010', '010011', '001010']",27,12,15,0.4444444444444444,0.5555555555555556,2,5,0.9910760598382222,1
"['1010', '11', '1111', '011', '000']",16,10,6,0.625,0.375,4,1,0.954434002924965,0
"['1010010', '1']",8,4,4,0.5,0.5,0,1,1.0,1
"['1111010', '01', '101', '101', '0000', '111101', '0', '101011', '000', '00']",37,19,18,0.5135135135135135,0.4864864864864865,7,5,0.9994730201859836,0
['0001'],4,1,3,0.25,0.75,0,1,0.8112781244591328,1
"['010110', '0', '001010', '1001']",17,7,10,0.4117647058823529,0.5882352941176471,1,3,0.9774178175281716,1
"['100', '10', '0', '101001', '0', '110011']",19,9,10,0.4736842105263157,0.5263157894736842,2,4,0.9980008838722996,0
"['1011010', '010', '0010001', '1011010']",24,11,13,0.4583333333333333,0.5416666666666666,3,3,0.99498482818597,1
"['0000', '011', '1000011', '10111', '111']",22,12,10,0.5454545454545454,0.4545454545454545,5,4,0.9940302114769564,1
"['11010', '0', '001']",9,4,5,0.4444444444444444,0.5555555555555556,1,2,0.9910760598382222,1
"['00', '0111110', '10110', '11', '001', '1100', '10', '00', '00101']",32,16,16,0.5,0.5,5,5,1.0,0
"['0', '00101', '1011', '0111100', '010', '110']",23,12,11,0.5217391304347826,0.4782608695652174,5,2,0.9986359641585718,0
"['1111', '101', '0000', '111']",14,9,5,0.6428571428571429,0.3571428571428571,3,2,0.9402859586706313,0
"['1001', '01000', '0', '111101', '101101', '00010', '0010001']",34,15,19,0.4411764705882353,0.5588235294117647,4,6,0.9899927915575186,0
"['1101', '11011']",9,7,2,0.7777777777777778,0.2222222222222222,3,0,0.7642045065086203,1
['0101101'],7,4,3,0.5714285714285714,0.4285714285714285,1,0,0.9852281360342516,1
"['0100', '0001111', '01', '1111', '011', '00001', '1', '101011']",32,18,14,0.5625,0.4375,7,4,0.9886994082884974,0
"['1110', '1000']",8,4,4,0.5,0.5,1,1,1.0,1
"['0', '101', '11', '00', '0010101', '0', '1001']",20,9,11,0.45,0.55,1,3,0.9927744539878084,0
"['010000', '110', '0010000', '101', '10', '10011', '0', '1111', '1100', '01100']",40,18,22,0.45,0.55,7,8,0.9927744539878084,0
"['01', '11010', '010', '1110001', '11', '00001']",24,12,12,0.5,0.5,3,4,1.0,0
"['1001010', '101111', '00', '01', '110010']",23,12,11,0.5217391304347826,0.4782608695652174,3,3,0.9986359641585718,1
"['0110', '0011000', '00010']",16,5,11,0.3125,0.6875,2,4,0.8960382325345574,1
['01'],2,1,1,0.5,0.5,0,0,1.0,1
"['1', '1011', '0001111', '01111', '01010', '000110', '11', '1']",31,19,12,0.6129032258064516,0.3870967741935484,8,3,0.9629004147713268,0
"['11', '001', '110', '1111011', '11100', '1010001', '000', '001']",33,18,15,0.5454545454545454,0.4545454545454545,6,5,0.9940302114769564,0
"['00', '111000', '01010', '1100', '01101', '0110110']",29,14,15,0.4827586206896552,0.5172413793103449,5,4,0.9991421039919088,1
"['01011', '0011000']",12,5,7,0.4166666666666667,0.5833333333333334,2,2,0.9798687566511528,1
"['1101', '11011', '100', '01', '1', '10', '10']",19,12,7,0.631578947368421,0.3684210526315789,4,1,0.9494520153879484,0
"['1', '1', '1001101']",9,6,3,0.6666666666666666,0.3333333333333333,2,1,0.9182958340544896,1
"['01111', '101011', '101010', '001', '10', '1', '1']",24,15,9,0.625,0.375,5,1,0.954434002924965,0
"['11111', '11', '1001001', '11', '00001', '00101', '0001', '1001110']",37,20,17,0.5405405405405406,0.4594594594594595,7,7,0.9952525494396792,0
"['00010', '11100', '001', '000010', '01', '0011101', '0110010']",35,14,21,0.4,0.6,3,8,0.9709505944546686,1
"['1001', '1', '11', '01010', '11001', '110', '0101', '0', '1']",26,15,11,0.5769230769230769,0.4230769230769231,4,3,0.9828586897127056,0
"['0', '0011111', '00100', '0', '00']",16,6,10,0.375,0.625,2,4,0.954434002924965,0
"['000', '01', '10']",7,2,5,0.2857142857142857,0.7142857142857143,1,2,0.863120568566631,1
"['1000', '1011', '0', '100', '100011', '010', '1100010', '001010']",34,14,20,0.4117647058823529,0.5882352941176471,3,5,0.9774178175281716,0
"['0000', '11', '00111', '00110', '01000', '11110']",26,12,14,0.4615384615384615,0.5384615384615384,5,6,0.9957274520849256,1
"['0100', '1001', '010000', '1100', '11101', '1110', '110', '11110', '01001', '1']",41,22,19,0.5365853658536586,0.4634146341463415,8,7,0.9961344835095796,0
"['1110010', '00']",9,4,5,0.4444444444444444,0.5555555555555556,1,2,0.9910760598382222,1
"['100', '100', '01', '00', '01', '11', '1']",15,7,8,0.4666666666666667,0.5333333333333333,2,3,0.9967916319816366,0
['100'],3,1,2,0.3333333333333333,0.6666666666666666,0,1,0.9182958340544896,1
"['11011', '10', '00', '00']",11,5,6,0.4545454545454545,0.5454545454545454,2,2,0.9940302114769564,1
"['1110', '0']",5,3,2,0.6,0.4,1,1,0.9709505944546686,1
"['1011', '01010', '110']",12,7,5,0.5833333333333334,0.4166666666666667,2,0,0.9798687566511528,1
"['0100', '11011', '000', '1100000', '0011']",23,9,14,0.391304347826087,0.6086956521739131,4,5,0.9656361333706098,1
"['111001', '001101', '111001', '110100', '10', '0010', '011010', '10101', '0101001', '10']",50,26,24,0.52,0.48,7,7,0.9988455359952018,0
"['10', '1111', '1101', '00', '0100', '0', '0']",18,9,9,0.5,0.5,3,3,1.0,0
"['101101', '011', '10101']",14,9,5,0.6428571428571429,0.3571428571428571,2,0,0.9402859586706313,1
"['011', '1', '110100', '0000011', '1', '011101', '1100']",28,15,13,0.5357142857142857,0.4642857142857143,5,4,0.996316519558962,0
"['101000', '00000', '001', '1110', '101']",21,8,13,0.3809523809523809,0.6190476190476191,2,5,0.9587118829771318,1
"['100', '0100010', '10']",12,4,8,0.3333333333333333,0.6666666666666666,0,2,0.9182958340544896,1
"['11', '00011', '1']",8,5,3,0.625,0.375,2,1,0.954434002924965,0
"['11111', '11', '001111', '1010']",17,13,4,0.7647058823529411,0.2352941176470588,5,1,0.7871265862012691,0
"['01', '1', '101', '000101', '0100', '111001', '011011']",28,15,13,0.5357142857142857,0.4642857142857143,4,3,0.996316519558962,0
"['001', '0101111', '10010', '1', '0', '0101']",21,11,10,0.5238095238095238,0.4761904761904761,2,3,0.998363672593813,0
"['000', '0', '111', '110', '011110', '1010001', '011']",26,14,12,0.5384615384615384,0.4615384615384615,5,4,0.9957274520849256,0
"['0', '0001001', '1001', '01110', '110', '0110000', '100', '101', '010000']",39,15,24,0.3846153846153846,0.6153846153846154,4,10,0.961236604722876,0
"['01110', '1100000', '10', '1', '0010', '0101001', '1010', '100']",33,14,19,0.4242424242424242,0.5757575757575758,3,6,0.9833761901392236,0
"['10', '1', '111', '10', '1101']",12,9,3,0.75,0.25,3,0,0.8112781244591328,0
"['1010', '111', '000']",10,5,5,0.5,0.5,1,1,1.0,1
"['1', '100', '10', '110', '101', '0110', '101001', '0011111']",29,17,12,0.5862068965517241,0.4137931034482758,5,3,0.9784493292686188,0
"['000', '00110', '1010', '10111']",17,8,9,0.4705882352941176,0.5294117647058824,2,2,0.9975025463691152,1
"['0011', '100', '00000', '01', '0001000', '01111', '0', '0001111', '0100001', '01']",43,16,27,0.3720930232558139,0.627906976744186,5,12,0.9522656254366642,0
"['0000', '101001', '11101', '00110', '011111', '001100', '11000', '111']",40,21,19,0.525,0.475,8,8,0.99819587904281,1
"['101', '0100101', '111', '110011', '00111', '011', '0001101', '1011', '1']",39,24,15,0.6153846153846154,0.3846153846153846,9,4,0.961236604722876,0
"['10', '100100', '01', '1010010', '0', '10000', '0', '00010', '10101', '1']",35,13,22,0.3714285714285714,0.6285714285714286,2,8,0.9517626756348312,0
"['0100110', '0000001', '1010100']",21,7,14,0.3333333333333333,0.6666666666666666,2,5,0.9182958340544896,1
['100111'],6,4,2,0.6666666666666666,0.3333333333333333,1,1,0.9182958340544896,1
"['01101', '11101', '0', '10010', '0']",17,9,8,0.5294117647058824,0.4705882352941176,3,2,0.9975025463691152,1
['101'],3,2,1,0.6666666666666666,0.3333333333333333,0,0,0.9182958340544896,1
"['1111', '0001', '0111000', '0100010', '00111', '111100', '01001', '101', '0']",42,21,21,0.5,0.5,7,7,1.0,0
"['0', '11110', '110', '0110']",13,8,5,0.6153846153846154,0.3846153846153846,4,1,0.961236604722876,0
['0000010'],7,1,6,0.1428571428571428,0.8571428571428571,0,2,0.5916727785823275,1
"['101', '010', '11', '00', '0111', '0101', '10']",20,11,9,0.55,0.45,3,1,0.9927744539878084,0
"['101011', '1010110', '110', '1', '100110', '110100', '100101', '001']",38,21,17,0.5526315789473685,0.4473684210526316,6,4,0.9919924034538556,0
"['00', '0101', '0101', '1', '111', '111']",17,11,6,0.6470588235294118,0.3529411764705882,4,1,0.9366673818775626,0
"['1', '0010100', '00', '00', '10110', '000010', '110', '0011100', '10', '110101']",41,17,24,0.4146341463414634,0.5853658536585366,4,8,0.9788698505067784,0
"['0111011', '001000', '010']",16,7,9,0.4375,0.5625,2,3,0.9886994082884974,1
"['011010', '1110001', '0011011', '101000', '11', '110100', '101110', '00000', '001011', '0111']",55,28,27,0.509090909090909,0.4909090909090909,9,8,0.9997615248696312,1
"['10100', '11110', '01', '1100', '000111', '0']",23,12,11,0.5217391304347826,0.4782608695652174,4,4,0.9986359641585718,0
"['11111', '100001', '101', '1111011', '1100', '01', '1111', '001']",34,23,11,0.6764705882352942,0.3235294117647059,10,4,0.9081783472997051,0
"['01', '10010']",7,3,4,0.4285714285714285,0.5714285714285714,1,1,0.9852281360342516,1
"['111101', '100', '01', '0111001', '11', '110', '011', '1110', '010011', '110']",39,25,14,0.6410256410256411,0.358974358974359,10,5,0.9418285354475155,0
"['1100', '00110', '0110', '101100', '0', '0', '0010']",25,10,15,0.4,0.6,4,6,0.9709505944546686,0
"['10000', '000', '101111', '110', '0', '0010', '0', '11011']",28,13,15,0.4642857142857143,0.5357142857142857,5,6,0.996316519558962,0
"['1010', '00010', '0']",10,3,7,0.3,0.7,0,3,0.8812908992306927,1
"['01011', '011000', '110001', '010001', '000', '01', '11', '010']",33,14,19,0.4242424242424242,0.5757575757575758,4,5,0.9833761901392236,0
"['0111010', '00011', '110001', '1110', '1001', '10011', '01', '110']",36,20,16,0.5555555555555556,0.4444444444444444,8,5,0.9910760598382222,0
['1010011'],7,4,3,0.5714285714285714,0.4285714285714285,1,1,0.9852281360342516,1
"['011001', '000111', '110010', '0', '00100', '1', '01010', '1010000']",37,15,22,0.4054054054054054,0.5945945945945946,3,8,0.974024864435752,0
"['1010', '111000', '010110', '00', '110011', '1000', '1110100', '0111001', '11010', '101']",50,26,24,0.52,0.48,7,7,0.9988455359952018,0
['000000'],6,0,6,0.0,1.0,0,3,-0.0,1
"['111011', '110010']",12,8,4,0.6666666666666666,0.3333333333333333,3,1,0.9182958340544896,1
"['000', '10011', '111000', '1011000', '101010', '0', '111011', '001100', '010100', '010011']",52,24,28,0.4615384615384615,0.5384615384615384,7,9,0.9957274520849256,0
"['000010', '01', '0', '0011', '1010', '11', '0001', '01']",25,10,15,0.4,0.6,2,5,0.9709505944546686,0
"['0', '111', '0', '001', '1101011', '000']",18,9,9,0.5,0.5,3,2,1.0,0
"['111001', '0', '111101', '00000']",18,9,9,0.5,0.5,3,3,1.0,0
"['00101', '01', '0', '11100', '101', '10', '0001']",22,10,12,0.4545454545454545,0.5454545454545454,2,4,0.9940302114769564,0
"['001', '110', '0', '0111', '0', '1101000', '0111', '0', '100100', '111000']",36,17,19,0.4722222222222222,0.5277777777777778,5,7,0.997772472089982,0
"['00', '011']",5,2,3,0.4,0.6,1,1,0.9709505944546686,1
"['1000', '01', '01100', '0', '0', '101011', '101111', '1100']",29,15,14,0.5172413793103449,0.4827586206896552,5,5,0.9991421039919088,0
['100'],3,1,2,0.3333333333333333,0.6666666666666666,0,1,0.9182958340544896,1
"['0111', '011', '01', '100']",12,7,5,0.5833333333333334,0.4166666666666667,3,1,0.9798687566511528,1
"['01011', '11101', '001111', '1011101', '0001100', '0101', '0']",35,20,15,0.5714285714285714,0.4285714285714285,6,3,0.9852281360342516,0
"['00010', '11', '00', '0010110', '0', '1010', '0000011']",28,10,18,0.3571428571428571,0.6428571428571429,3,7,0.9402859586706313,0
"['11001', '10111', '100', '001010', '110', '1']",23,13,10,0.5652173913043478,0.4347826086956521,5,3,0.9876925088958034,0
"['001', '01', '111', '111101', '0110', '11', '1']",21,15,6,0.7142857142857143,0.2857142857142857,6,1,0.863120568566631,0
"['1001', '11', '0001010', '0101100', '001011']",26,12,14,0.4615384615384615,0.5384615384615384,3,5,0.9957274520849256,1
"['0', '101', '1011100', '1001011', '011', '1001110', '001', '0101101', '0', '00']",41,21,20,0.5121951219512195,0.4878048780487805,6,5,0.9995708393473224,0
"['10', '010', '1', '01']",8,4,4,0.5,0.5,0,1,1.0,0
"['0011010', '1']",8,4,4,0.5,0.5,1,1,1.0,1
"['0', '111011', '011001', '010']",16,9,7,0.5625,0.4375,3,1,0.9886994082884974,1
"['10111', '0010', '010010', '010', '0011', '1']",23,11,12,0.4782608695652174,0.5217391304347826,2,5,0.9986359641585718,0
"['1110110', '0001100', '000011', '10010', '100010', '0', '100', '1011', '1001']",43,19,24,0.4418604651162791,0.5581395348837209,5,10,0.9902246902198684,0
"['1', '1101010', '010', '0000', '0111', '1', '01111', '010']",28,15,13,0.5357142857142857,0.4642857142857143,5,4,0.996316519558962,0
"['11', '001', '0', '1101', '10011', '011', '010', '001', '1001', '10111']",33,19,14,0.5757575757575758,0.4242424242424242,8,4,0.9833761901392236,0
"['011', '1101100', '01', '01011', '1', '10010', '11110', '111', '0']",32,20,12,0.625,0.375,8,2,0.954434002924965,0
"['0', '111011', '11', '110101', '0101', '10111', '0111000', '01010', '01110', '0011111']",48,30,18,0.625,0.375,10,4,0.954434002924965,0
"['1010', '0', '001', '01110']",13,6,7,0.4615384615384615,0.5384615384615384,1,2,0.9957274520849256,1
"['111000', '010001']",12,5,7,0.4166666666666667,0.5833333333333334,1,3,0.9798687566511528,1
"['1', '0010101', '000101', '1', '001', '10010', '110']",26,12,14,0.4615384615384615,0.5384615384615384,3,4,0.9957274520849256,1
"['00101', '0', '0', '001111', '001001']",19,8,11,0.4210526315789473,0.5789473684210527,2,5,0.9819407868640976,1
"['111000', '00101', '1']",12,6,6,0.5,0.5,2,2,1.0,1
"['01010', '000000', '10', '01', '1001']",19,6,13,0.3157894736842105,0.6842105263157895,1,5,0.8997437586982626,0
"['0111110', '101', '1100', '011110', '1010100', '0000', '01', '1', '01', '001']",39,20,19,0.5128205128205128,0.4871794871794871,6,5,0.999525689293649,0
['1'],1,1,0,1.0,0.0,0,0,-0.0,1
"['0011111', '101', '110000', '101100', '11110']",27,16,11,0.5925925925925926,0.4074074074074074,7,4,0.975119064940866,1
"['10', '110', '1', '01111', '10001', '00100']",21,11,10,0.5238095238095238,0.4761904761904761,3,3,0.998363672593813,0
"['0001111', '0010', '101', '0001010', '0', '0001', '11101', '01', '11']",35,17,18,0.4857142857142857,0.5142857142857142,5,5,0.9994110647387552,0
"['010001', '110', '11100', '111', '10', '1100111', '0101111']",33,21,12,0.6363636363636364,0.3636363636363636,8,3,0.94566030460064,1
"['100', '1110', '0001101', '1', '1']",16,9,7,0.5625,0.4375,3,3,0.9886994082884974,1
"['00', '1101011', '11', '110010', '01011']",22,13,9,0.5909090909090909,0.4090909090909091,5,3,0.9760206482366148,0
"['010101', '100', '11110', '1', '11', '10011', '0110111', '11', '1010']",35,23,12,0.6571428571428571,0.3428571428571428,10,2,0.927526588431676,0
"['1101110', '10', '0100100', '111001', '11', '1', '110111']",31,20,11,0.6451612903225806,0.3548387096774194,7,4,0.9383153522334068,0
"['1', '1', '01001', '10', '1', '10', '010011']",18,10,8,0.5555555555555556,0.4444444444444444,4,3,0.9910760598382222,0
"['1000011', '101', '111', '1010', '111', '10']",22,14,8,0.6363636363636364,0.3636363636363636,5,2,0.94566030460064,0
"['010110', '1', '1011101', '1001101', '11', '111000', '01010', '111101']",40,25,15,0.625,0.375,10,3,0.954434002924965,0
"['0', '01', '0010011']",10,4,6,0.4,0.6,1,3,0.9709505944546686,1
"['11', '101']",5,4,1,0.8,0.2,1,0,0.7219280948873623,1
['0'],1,0,1,0.0,1.0,0,0,-0.0,1
"['11011', '00', '0111', '01', '111', '0', '11']",19,13,6,0.6842105263157895,0.3157894736842105,6,1,0.8997437586982626,0
"['011', '1001', '1001', '001']",14,7,7,0.5,0.5,2,3,1.0,1
"['0', '111100', '10', '01100', '011000', '001010', '0111']",30,14,16,0.4666666666666667,0.5333333333333333,5,6,0.9967916319816366,0
"['0', '001', '0101100', '1', '10001', '00110', '0010010']",29,11,18,0.3793103448275862,0.6206896551724138,3,6,0.9575534837147482,0
"['0011', '001001', '101', '1011', '0000101', '00', '1', '111111', '100010', '0101110']",46,24,22,0.5217391304347826,0.4782608695652174,9,8,0.9986359641585718,0
"['1111', '10', '00101', '010', '0', '10']",17,9,8,0.5294117647058824,0.4705882352941176,2,2,0.9975025463691152,0
"['0010', '0', '00']",7,1,6,0.1428571428571428,0.8571428571428571,0,3,0.5916727785823275,0
"['0011', '1110010', '11011', '10', '1', '01', '0111', '1', '100']",29,18,11,0.6206896551724138,0.3793103448275862,6,3,0.9575534837147482,0
['010000'],6,1,5,0.1666666666666666,0.8333333333333334,0,2,0.6500224216483541,1
"['1011', '01']",6,4,2,0.6666666666666666,0.3333333333333333,1,0,0.9182958340544896,1
"['01', '0', '0011', '111', '0']",11,6,5,0.5454545454545454,0.4545454545454545,2,1,0.9940302114769564,1
"['11000', '0110101', '01101', '1', '1100110', '100', '00']",30,15,15,0.5,0.5,6,5,1.0,0
"['10101', '00', '0110', '111000', '1100101', '11', '000']",29,14,15,0.4827586206896552,0.5172413793103449,4,4,0.9991421039919088,0
"['0010', '0101', '001111', '10001']",19,9,10,0.4736842105263157,0.5263157894736842,2,4,0.9980008838722996,1
"['0', '01', '110', '111110', '10', '110', '101', '0']",21,13,8,0.6190476190476191,0.3809523809523809,4,1,0.9587118829771318,0
"['1100', '1101100', '101', '0', '1101001', '10', '0100']",28,14,14,0.5,0.5,5,5,1.0,0
"['110', '010001', '01', '1100', '101110', '001100', '01000']",32,14,18,0.4375,0.5625,4,6,0.9886994082884974,0
"['1011001', '0011', '101111', '0011', '0101010', '0010000', '011', '0001', '110']",45,22,23,0.4888888888888889,0.5111111111111111,7,7,0.999643749677856,1
"['11010', '11', '0', '010', '100101', '0000101', '1']",25,12,13,0.48,0.52,3,4,0.9988455359952018,0
['0000001'],7,1,6,0.1428571428571428,0.8571428571428571,0,3,0.5916727785823275,1
"['101010', '001', '0110000']",16,6,10,0.375,0.625,1,3,0.954434002924965,1
"['0', '1111', '0', '11', '00010', '010000']",19,8,11,0.4210526315789473,0.5789473684210527,3,4,0.9819407868640976,0
"['111100', '1', '1011', '001', '11010', '101', '0111010', '1100', '111110', '0']",40,25,15,0.625,0.375,9,4,0.954434002924965,0
"['0110110', '1011']",11,7,4,0.6363636363636364,0.3636363636363636,3,0,0.94566030460064,1
"['11000', '1']",6,3,3,0.5,0.5,1,1,1.0,1
"['0110', '10', '1010', '1110', '0000000', '0010001', '01', '11']",32,13,19,0.40625,0.59375,3,6,0.9744894033980523,0
"['0', '0000', '11000', '11', '01', '00001']",19,6,13,0.3157894736842105,0.6842105263157895,2,5,0.8997437586982626,0
"['00010', '00', '111010']",13,5,8,0.3846153846153846,0.6153846153846154,1,2,0.961236604722876,1
"['1101', '10', '0111000']",13,7,6,0.5384615384615384,0.4615384615384615,3,2,0.9957274520849256,1
"['101001', '0010']",10,4,6,0.4,0.6,0,2,0.9709505944546686,1
"['1', '10001', '001', '010', '100011', '010011', '00', '101111']",32,16,16,0.5,0.5,5,5,1.0,0
"['00', '11', '010001', '0010', '1', '010']",18,7,11,0.3888888888888889,0.6111111111111112,1,3,0.964078764808229,0
"['1010011', '0', '001', '0110000', '10', '1100001']",27,11,16,0.4074074074074074,0.5925925925925926,3,6,0.975119064940866,0
"['0110', '1010', '1010001', '100101', '00100', '000', '0', '101', '0111', '1']",38,17,21,0.4473684210526316,0.5526315789473685,4,6,0.9919924034538556,0
"['010101', '00', '1010001', '000']",18,6,12,0.3333333333333333,0.6666666666666666,0,3,0.9182958340544896,0
"['1110110', '1', '10', '11', '0000011', '1', '1100', '001', '01100', '1']",33,18,15,0.5454545454545454,0.4545454545454545,7,5,0.9940302114769564,0
"['0110', '101', '0']",8,4,4,0.5,0.5,1,0,1.0,1
"['101', '001110', '0', '0', '0001', '101101', '1001', '101000', '1']",32,15,17,0.46875,0.53125,5,6,0.9971803988942642,0
['011011'],6,4,2,0.6666666666666666,0.3333333333333333,2,0,0.9182958340544896,1
"['000', '100', '1', '01', '110', '10000', '11001', '1101', '101', '111000']",35,17,18,0.4857142857142857,0.5142857142857142,6,6,0.9994110647387552,0
"['00110', '0111011', '0', '11', '100', '1011']",22,13,9,0.5909090909090909,0.4090909090909091,5,3,0.9760206482366148,0
"['01011', '1001', '110', '100110', '0101001', '0110', '0101']",33,17,16,0.5151515151515151,0.4848484848484848,4,5,0.9993375041688848,0
"['00101', '101001', '101', '01001', '1011001', '100']",29,14,15,0.4827586206896552,0.5172413793103449,5,5,0.9991421039919088,0
"['10100', '110100', '111', '0', '010', '01', '101110', '10011', '001']",34,18,16,0.5294117647058824,0.4705882352941176,5,6,0.9975025463691152,0
['11'],2,2,0,1.0,0.0,1,0,-0.0,1
"['0', '00001', '11', '1', '0010', '01010']",18,7,11,0.3888888888888889,0.6111111111111112,2,4,0.964078764808229,0
"['1001', '0000011', '010', '0110111', '0101110', '1000', '101010']",38,18,20,0.4736842105263157,0.5263157894736842,4,5,0.9980008838722996,1
"['110', '011', '01010', '000010', '0010']",21,8,13,0.3809523809523809,0.6190476190476191,2,4,0.9587118829771318,1
"['01', '1', '000', '010', '1011', '0000000', '110', '100100', '110', '1011010']",39,16,23,0.4102564102564102,0.5897435897435898,5,7,0.97663491144401,0
"['00010', '11', '10', '000', '10', '0111111', '11', '000', '10111']",31,17,14,0.5483870967741935,0.4516129032258064,6,5,0.9932338197397066,0
"['1111', '0110100', '1011', '00010', '101010', '00100', '0010011', '100']",41,19,22,0.4634146341463415,0.5365853658536586,5,7,0.9961344835095796,1
"['1110110', '1111010', '1011111', '100000', '001', '100001', '101001']",42,23,19,0.5476190476190477,0.4523809523809524,9,6,0.9934472383802028,1
"['0100', '0', '001001', '000', '101', '011', '10', '1101', '11', '100']",31,14,17,0.4516129032258064,0.5483870967741935,4,5,0.9932338197397066,0
"['00101', '1010', '1010010', '1', '001', '101001', '00', '11', '110010']",36,17,19,0.4722222222222222,0.5277777777777778,4,6,0.997772472089982,0
"['010', '0001000', '100']",13,3,10,0.2307692307692307,0.7692307692307693,0,4,0.7793498372920851,1
"['11', '10101', '1', '0010', '01001', '0', '01100', '0000101']",30,13,17,0.4333333333333333,0.5666666666666667,3,7,0.9871377743721864,0
"['011', '101', '11110']",11,8,3,0.7272727272727273,0.2727272727272727,3,0,0.8453509366224364,1
"['110011', '00', '00110', '0110001', '00110', '100001']",31,13,18,0.4193548387096774,0.5806451612903226,5,8,0.9811522341999132,1
"['0100111', '01111', '11', '00001', '00', '001', '000']",27,12,15,0.4444444444444444,0.5555555555555556,4,6,0.9910760598382222,0
['1'],1,1,0,1.0,0.0,0,0,-0.0,1
['10'],2,1,1,0.5,0.5,0,0,1.0,1
"['110101', '00', '0101', '1', '1']",14,8,6,0.5714285714285714,0.4285714285714285,2,1,0.9852281360342516,0
"['1110', '001', '011', '111011']",16,11,5,0.6875,0.3125,4,1,0.8960382325345574,1
"['11', '00100', '0', '01', '0', '1', '1000011', '01']",21,9,12,0.4285714285714285,0.5714285714285714,3,5,0.9852281360342516,0
"['10', '0111001', '101000', '011111', '1010', '110011', '0100111', '000', '0']",42,22,20,0.5238095238095238,0.4761904761904761,8,8,0.998363672593813,0
"['00', '10', '111']",7,4,3,0.5714285714285714,0.4285714285714285,1,1,0.9852281360342516,1
"['0', '0000000', '1', '01000', '0101', '010', '0']",22,5,17,0.2272727272727272,0.7727272727272727,0,7,0.7732266742876346,0
"['01010', '1011', '010010', '10011', '01', '11010', '010000', '0100011', '10']",42,19,23,0.4523809523809524,0.5476190476190477,4,6,0.9934472383802028,0
"['00', '1011001', '00000', '0110101']",21,8,13,0.3809523809523809,0.6190476190476191,2,5,0.9587118829771318,0
"['010', '0', '11', '000100']",12,4,8,0.3333333333333333,0.6666666666666666,1,3,0.9182958340544896,0
['10011'],5,3,2,0.6,0.4,1,1,0.9709505944546686,1
['1'],1,1,0,1.0,0.0,0,0,-0.0,1
"['101110', '11', '0110111', '0111010', '00', '0000', '110', '0', '11000']",37,19,18,0.5135135135135135,0.4864864864864865,7,5,0.9994730201859836,0
"['10000', '1011', '10101', '0100000', '0111', '00', '0100010', '1011', '001', '0']",42,17,25,0.4047619047619047,0.5952380952380952,3,8,0.97366806454962,0
"['1100101', '1101001', '0', '1110', '0101', '000111']",29,16,13,0.5517241379310345,0.4482758620689655,4,4,0.9922666387194964,0
"['1', '0', '010']",5,2,3,0.4,0.6,0,1,0.9709505944546686,0
"['01011', '0011101']",12,7,5,0.5833333333333334,0.4166666666666667,2,1,0.9798687566511528,1
['0001'],4,1,3,0.25,0.75,0,1,0.8112781244591328,1
"['1101', '00001', '1010100', '0011101']",23,11,12,0.4782608695652174,0.5217391304347826,3,4,0.9986359641585718,1
"['011000', '1111000', '0111', '1', '000', '110']",24,12,12,0.5,0.5,6,4,1.0,0
"['1101', '1110011', '0', '000000', '0', '111']",22,11,11,0.5,0.5,5,5,1.0,0
"['000', '100', '0101', '1111']",14,7,7,0.5,0.5,2,2,1.0,1
"['0010011', '00', '1', '1101', '0010110', '110', '1101111', '10111', '101101', '11']",44,28,16,0.6363636363636364,0.3636363636363636,11,4,0.94566030460064,0
['0110'],4,2,2,0.5,0.5,1,0,1.0,1
"['1', '0', '01', '101000', '111001', '100100']",22,10,12,0.4545454545454545,0.5454545454545454,3,5,0.9940302114769564,0
"['001111', '0', '11011', '0010101', '001', '11', '111', '110']",30,19,11,0.6333333333333333,0.3666666666666666,8,3,0.9480782435939056,0
"['1010', '01000', '10100', '11111']",19,10,9,0.5263157894736842,0.4736842105263157,2,3,0.9980008838722996,1
"['01000', '0110']",9,3,6,0.3333333333333333,0.6666666666666666,1,2,0.9182958340544896,1
"['00', '11010', '01', '010', '001010', '011', '001011', '0000']",31,12,19,0.3870967741935484,0.6129032258064516,3,7,0.9629004147713268,0
"['100', '101', '1111101', '0', '110111', '0010', '110010', '1', '1', '000']",35,20,15,0.5714285714285714,0.4285714285714285,7,4,0.9852281360342516,0
"['0000', '001', '10', '010', '1', '10111']",18,8,10,0.4444444444444444,0.5555555555555556,3,4,0.9910760598382222,0
"['0110', '111010', '100', '10110', '100000']",24,11,13,0.4583333333333333,0.5416666666666666,3,3,0.99498482818597,1
"['010001', '0', '11', '11']",11,6,5,0.5454545454545454,0.4545454545454545,2,1,0.9940302114769564,1
"['0011', '101', '00100', '1001', '11101', '101111', '0']",28,16,12,0.5714285714285714,0.4285714285714285,6,4,0.9852281360342516,0
"['1', '11', '01', '00100', '1', '0110101', '0', '001101', '00', '0111000']",34,16,18,0.4705882352941176,0.5294117647058824,4,5,0.9975025463691152,0
"['001', '01', '0011']",9,4,5,0.4444444444444444,0.5555555555555556,1,2,0.9910760598382222,1
"['10000', '010', '0100011', '11110', '1']",21,10,11,0.4761904761904761,0.5238095238095238,3,4,0.998363672593813,1
"['100', '10', '01', '1010', '11', '1', '0']",15,8,7,0.5333333333333333,0.4666666666666667,2,2,0.9967916319816366,0
"['000', '1101', '011', '000110', '00', '1001100', '01011', '00']",32,13,19,0.40625,0.59375,5,6,0.9744894033980523,0
"['1110', '010110', '1', '11010']",16,10,6,0.625,0.375,3,1,0.954434002924965,1
"['01', '10', '110111', '0001', '01100', '101', '0110']",26,14,12,0.5384615384615384,0.4615384615384615,5,2,0.9957274520849256,0
"['11110', '0']",6,4,2,0.6666666666666666,0.3333333333333333,2,1,0.9182958340544896,1
"['11', '101', '01', '01', '0101000', '1110', '10001', '0001', '0', '1111111']",37,21,16,0.5675675675675675,0.4324324324324324,5,3,0.9867867202680318,0
"['01', '101100', '1']",9,5,4,0.5555555555555556,0.4444444444444444,2,1,0.9910760598382222,1
"['0010', '01001', '001', '0000011', '010011', '11', '110011', '11', '000010']",41,18,23,0.4390243902439024,0.5609756097560976,6,10,0.9892452969285004,0
"['101010', '1001', '01', '001000']",18,7,11,0.3888888888888889,0.6111111111111112,0,3,0.964078764808229,1
"['1100010', '010', '100', '1', '01', '10110']",21,10,11,0.4761904761904761,0.5238095238095238,3,3,0.998363672593813,0
"['00', '1111', '1010', '0000111', '001']",20,10,10,0.5,0.5,3,4,1.0,1
"['0010', '1000', '10', '010']",13,4,9,0.3076923076923077,0.6923076923076923,0,3,0.8904916402194913,0
"['00', '1', '010', '10', '1110']",12,6,6,0.5,0.5,1,1,1.0,0
"['10', '010101', '11', '01', '010000']",18,8,10,0.4444444444444444,0.5555555555555556,1,3,0.9910760598382222,0
"['000101', '10010', '11100', '001']",19,8,11,0.4210526315789473,0.5789473684210527,2,4,0.9819407868640976,1
"['01', '01001', '0010010', '0001001', '1111']",25,11,14,0.44,0.56,2,6,0.9895875212220556,0
"['100101', '10', '0011111', '00', '10010']",22,11,11,0.5,0.5,3,4,1.0,0
"['001', '10000', '0111', '010100', '1001111', '1', '000', '0']",30,13,17,0.4333333333333333,0.5666666666666667,4,7,0.9871377743721864,0
"['001101', '1000', '111', '011110', '001', '11', '0101']",28,16,12,0.5714285714285714,0.4285714285714285,6,3,0.9852281360342516,0
"['00', '101', '01100', '01', '0110111', '1100', '1011']",27,15,12,0.5555555555555556,0.4444444444444444,5,3,0.9910760598382222,0
['0011'],4,2,2,0.5,0.5,1,1,1.0,1
"['001010', '0', '001010', '011', '101', '00', '0', '011100', '1']",29,12,17,0.4137931034482758,0.5862068965517241,2,7,0.9784493292686188,0
"['01110', '1110', '01011', '01011', '100', '0101', '1101', '010011']",36,21,15,0.5833333333333334,0.4166666666666667,6,3,0.9798687566511528,1
"['01', '10', '010', '0', '1', '01011']",14,7,7,0.5,0.5,2,2,1.0,0
"['111', '000110', '00', '10', '1110010', '110']",23,12,11,0.5217391304347826,0.4782608695652174,4,3,0.9986359641585718,0
"['011000', '00', '00000', '001110', '0111', '001111']",29,12,17,0.4137931034482758,0.5862068965517241,5,8,0.9784493292686188,0
"['0', '0001100', '11', '0111000']",17,7,10,0.4117647058823529,0.5882352941176471,3,4,0.9774178175281716,0
"['1110011', '0', '00', '11101', '110', '1', '1011100', '1100000']",33,18,15,0.5454545454545454,0.4545454545454545,7,5,0.9940302114769564,0
"['01', '11111', '1010', '1110110']",18,13,5,0.7222222222222222,0.2777777777777778,5,0,0.8524051786494786,1
"['0100000', '10', '1001']",13,4,9,0.3076923076923077,0.6923076923076923,0,3,0.8904916402194913,1
"['1', '100010', '111111', '0100', '00111', '0100', '1000']",30,15,15,0.5,0.5,5,5,1.0,0
"['0', '1000001', '0010101', '0', '00001', '0', '110', '1001', '011']",32,12,20,0.375,0.625,2,6,0.954434002924965,0
['100110'],6,3,3,0.5,0.5,1,1,1.0,1
"['00100', '0101', '01', '1', '011010', '01', '001011', '10', '1001010']",35,16,19,0.4571428571428571,0.5428571428571428,3,5,0.9946937953613058,0
"['010', '11001', '1000', '1000100', '00110', '10001']",29,11,18,0.3793103448275862,0.6206896551724138,3,6,0.9575534837147482,1
"['11111', '00001', '00001']",15,7,8,0.4666666666666667,0.5333333333333333,2,4,0.9967916319816366,1
"['0011', '00110', '0100', '0101110', '001', '0010001', '0000110']",37,14,23,0.3783783783783784,0.6216216216216216,4,9,0.9568886656798212,0
"['0', '01000', '11', '0', '011', '010011', '0110']",22,10,12,0.4545454545454545,0.5454545454545454,4,4,0.9940302114769564,0
"['0101001', '1000']",11,4,7,0.3636363636363636,0.6363636363636364,1,2,0.94566030460064,1
"['0110', '0', '000', '0']",9,2,7,0.2222222222222222,0.7777777777777778,1,3,0.7642045065086203,0
"['1011', '100001', '100', '0', '1001001']",21,9,12,0.4285714285714285,0.5714285714285714,2,5,0.9852281360342516,0
"['011', '1', '10011', '0', '10011', '1']",16,10,6,0.625,0.375,4,2,0.954434002924965,0
"['111000', '00010', '10000', '010111', '0001001', '01001', '110011', '1']",41,18,23,0.4390243902439024,0.5609756097560976,4,9,0.9892452969285004,1
"['01', '00', '011', '11', '00', '1100100', '1001', '001111', '0110']",32,16,16,0.5,0.5,6,6,1.0,0
"['010', '111000', '1100', '010']",16,7,9,0.4375,0.5625,2,2,0.9886994082884974,1
"['10110', '0110011', '0001', '011101', '000']",25,12,13,0.48,0.52,4,4,0.9988455359952018,1
"['001', '1001110']",10,5,5,0.5,0.5,2,2,1.0,1
"['111010', '010111', '1']",13,9,4,0.6923076923076923,0.3076923076923077,3,1,0.8904916402194913,0
"['010', '00100', '00', '100', '1', '0', '010']",18,5,13,0.2777777777777778,0.7222222222222222,0,5,0.8524051786494786,0
"['00101', '10100', '110', '10', '0010100']",22,9,13,0.4090909090909091,0.5909090909090909,2,4,0.9760206482366148,0
"['1110001', '001101', '11000', '0101010', '111']",28,15,13,0.5357142857142857,0.4642857142857143,4,4,0.996316519558962,1
"['011', '110', '1000110', '0111', '01100']",22,12,10,0.5454545454545454,0.4545454545454545,5,3,0.9940302114769564,1
"['111011', '110', '1000']",13,8,5,0.6153846153846154,0.3846153846153846,3,1,0.961236604722876,1
"['110', '10000']",8,3,5,0.375,0.625,1,2,0.954434002924965,1
"['011', '10', '000101', '1011']",15,8,7,0.5333333333333333,0.4666666666666667,3,2,0.9967916319816366,1
"['0110101', '010010', '001', '1100000']",23,9,14,0.391304347826087,0.6086956521739131,2,4,0.9656361333706098,1
"['0111', '1000100', '010', '110', '10']",19,9,10,0.4736842105263157,0.5263157894736842,3,2,0.9980008838722996,1
"['0', '0100', '00', '11000', '1', '010000']",19,5,14,0.2631578947368421,0.7368421052631579,1,6,0.8314743880097293,0
"['101', '0001', '01101', '01001', '101', '101001', '1000010', '001101']",39,18,21,0.4615384615384615,0.5384615384615384,5,6,0.9957274520849256,0
"['10', '00101', '000110', '100111', '0', '10', '1', '11']",25,13,12,0.52,0.48,3,3,0.9988455359952018,0
"['011', '0']",4,2,2,0.5,0.5,1,0,1.0,1
"['11', '0010', '0001', '1011', '110111', '011111', '010010', '100', '0100111']",42,24,18,0.5714285714285714,0.4285714285714285,8,6,0.9852281360342516,0
"['0', '110101', '1', '1', '001001', '111010', '0011011', '100001', '00']",36,18,18,0.5,0.5,6,6,1.0,0
"['101111', '1001', '0001110', '101111', '0001', '1', '000', '0110', '00110']",40,21,19,0.525,0.475,8,6,0.99819587904281,0
['00010'],5,1,4,0.2,0.8,0,1,0.7219280948873623,1
"['11001', '001000', '1']",12,5,7,0.4166666666666667,0.5833333333333334,1,3,0.9798687566511528,1
"['0110010', '10010', '1', '110', '1110001', '111', '10', '010']",31,17,14,0.5483870967741935,0.4516129032258064,5,4,0.9932338197397066,0
['11'],2,2,0,1.0,0.0,1,0,-0.0,1
"['01111', '11', '00011', '11', '101111', '01', '011']",25,18,7,0.72,0.28,8,1,0.8554508105601306,0
"['111111', '00001', '0', '01']",14,8,6,0.5714285714285714,0.4285714285714285,3,3,0.9852281360342516,0
"['01111', '011001', '1', '1', '1111111', '1011101', '011', '000', '100100']",39,25,14,0.6410256410256411,0.358974358974359,10,4,0.9418285354475155,0
"['01110', '00011', '01', '010', '010', '0000']",22,8,14,0.3636363636363636,0.6363636363636364,2,5,0.94566030460064,1
"['000', '0110', '0', '101010', '00', '10', '111', '00', '11', '1']",26,12,14,0.4615384615384615,0.5384615384615384,3,5,0.9957274520849256,0
['10'],2,1,1,0.5,0.5,0,0,1.0,1
"['1010111', '0101', '001101', '1000000', '010']",27,12,15,0.4444444444444444,0.5555555555555556,3,4,0.9910760598382222,1
"['10', '0', '10110', '1010', '10110', '011011', '1011001', '111100', '000']",39,21,18,0.5384615384615384,0.4615384615384615,7,5,0.9957274520849256,0
"['00100', '000', '0100', '101', '110', '000010', '0100111', '1010', '0']",36,13,23,0.3611111111111111,0.6388888888888888,3,10,0.943601631299382,0
['101'],3,2,1,0.6666666666666666,0.3333333333333333,0,0,0.9182958340544896,1
"['111', '010101', '001', '10000', '01', '1', '10010', '0']",26,12,14,0.4615384615384615,0.5384615384615384,3,5,0.9957274520849256,0
"['0011', '0', '01001', '01', '10000', '1011']",21,9,12,0.4285714285714285,0.5714285714285714,3,5,0.9852281360342516,0
"['10010', '01', '1']",8,4,4,0.5,0.5,1,2,1.0,1
"['01', '111100', '00', '001', '011010']",19,9,10,0.4736842105263157,0.5263157894736842,3,3,0.9980008838722996,1
"['10001', '11', '1', '01', '0111111', '010001', '000110', '0010', '100', '101']",39,20,19,0.5128205128205128,0.4871794871794871,6,5,0.999525689293649,0
"['10011', '00001']",10,4,6,0.4,0.6,1,3,0.9709505944546686,1
"['010', '110101', '010001', '1010', '11']",21,11,10,0.5238095238095238,0.4761904761904761,3,1,0.998363672593813,0
"['0001', '1', '01011', '0011001', '1000', '01110', '110010']",32,15,17,0.46875,0.53125,6,6,0.9971803988942642,0
"['10110', '0011', '110']",12,7,5,0.5833333333333334,0.4166666666666667,3,1,0.9798687566511528,1
"['11', '111']",5,5,0,1.0,0.0,2,0,-0.0,0
['1'],1,1,0,1.0,0.0,0,0,-0.0,1
"['10110', '1', '0110', '1010011', '100000', '01110', '011', '1', '1', '1100100']",40,21,19,0.525,0.475,7,7,0.99819587904281,0
"['0000100', '111', '01101', '0001', '100011', '0001', '00111', '010']",37,16,21,0.4324324324324324,0.5675675675675675,5,7,0.9867867202680318,1
"['1101101', '0011', '100011', '00000', '0000', '0111101']",33,15,18,0.4545454545454545,0.5454545454545454,6,7,0.9940302114769564,0
"['01', '11100', '11', '00', '010', '0100001', '101010', '00010', '00']",34,13,21,0.3823529411764705,0.6176470588235294,4,8,0.9596868937742168,0
"['00101', '100011', '10', '0', '101000']",20,8,12,0.4,0.6,2,4,0.9709505944546686,0
"['1110000', '0101010', '100', '11100', '00100', '010', '0010']",34,13,21,0.3823529411764705,0.6176470588235294,2,7,0.9596868937742168,0
"['00100', '1000011', '11']",14,6,8,0.4285714285714285,0.5714285714285714,2,4,0.9852281360342516,1
"['1', '110', '010010', '1']",11,6,5,0.5454545454545454,0.4545454545454545,1,2,0.9940302114769564,1
"['1111', '10', '1101', '00', '101', '0110110', '1111', '000', '0', '1101010']",37,22,15,0.5945945945945946,0.4054054054054054,8,3,0.974024864435752,0
"['1110110', '00', '11000']",14,7,7,0.5,0.5,3,2,1.0,1
"['0111010', '10', '1000000', '000011', '010100', '1', '0', '0']",31,11,20,0.3548387096774194,0.6451612903225806,2,7,0.9383153522334068,0
"['010', '1', '0010', '00', '0', '0111', '111']",18,9,9,0.5,0.5,3,3,1.0,0
"['11110', '1', '0110011']",13,9,4,0.6923076923076923,0.3076923076923077,4,1,0.8904916402194913,1
['11010'],5,3,2,0.6,0.4,1,0,0.9709505944546686,1
"['0000111', '10011', '000111', '1100', '0', '1011', '111', '0110010']",37,20,17,0.5405405405405406,0.4594594594594595,8,6,0.9952525494396792,0
"['1100111', '1001101', '01001', '00101', '11100', '11', '1000011']",38,21,17,0.5526315789473685,0.4473684210526316,8,7,0.9919924034538556,1
"['0000', '1', '0110', '1']",10,4,6,0.4,0.6,1,2,0.9709505944546686,1
"['010', '1100', '0001100', '0001', '001100', '01', '010']",29,10,19,0.3448275862068966,0.6551724137931034,3,6,0.9293636260137188,0
"['1', '110', '11001', '010', '11', '1']",15,10,5,0.6666666666666666,0.3333333333333333,3,1,0.9182958340544896,0
"['0010', '01', '1011', '000']",13,5,8,0.3846153846153846,0.6153846153846154,2,3,0.961236604722876,1
"['1', '01100', '110111']",12,8,4,0.6666666666666666,0.3333333333333333,3,1,0.9182958340544896,1
"['01001', '0011', '1101', '01100', '1']",19,10,9,0.5263157894736842,0.4736842105263157,3,3,0.9980008838722996,0
"['1111', '0', '000010', '111', '0000', '100111', '1']",25,13,12,0.52,0.48,5,5,0.9988455359952018,0
"['0001100', '100010', '100']",16,5,11,0.3125,0.6875,1,4,0.8960382325345574,1
"['10010', '111', '0', '00111', '0111', '110', '1001']",25,15,10,0.6,0.4,4,3,0.9709505944546686,0
"['000', '1110011', '0110011']",17,9,8,0.5294117647058824,0.4705882352941176,4,3,0.9975025463691152,1
"['01', '111001', '01001', '0010100', '1', '0000001', '1', '0011001', '0101010']",43,18,25,0.4186046511627907,0.5813953488372093,4,9,0.9807983646944296,0
"['11', '0', '00010', '010', '10', '00', '1', '00011', '1']",22,9,13,0.4090909090909091,0.5909090909090909,2,5,0.9760206482366148,0
"['1001100', '000100', '0', '111111']",20,10,10,0.5,0.5,4,4,1.0,1
"['11', '000010']",8,3,5,0.375,0.625,1,2,0.954434002924965,1
"['010111', '0110010', '001011', '01']",21,11,10,0.5238095238095238,0.4761904761904761,3,2,0.998363672593813,1
"['1', '1101001', '11101', '0101001', '011', '111000', '1000000']",36,18,18,0.5,0.5,5,6,1.0,0
"['001011', '1111110']",13,9,4,0.6923076923076923,0.3076923076923077,4,1,0.8904916402194913,1
"['010111', '11101', '001110', '0110110']",24,15,9,0.625,0.375,6,2,0.954434002924965,1
"['01110', '11111', '10', '1', '1010', '110', '010000', '011', '111110', '101']",38,24,14,0.631578947368421,0.3684210526315789,9,3,0.9494520153879484,0
"['1101', '0', '010011', '0', '1', '000', '011']",19,9,10,0.4736842105263157,0.5263157894736842,3,4,0.9980008838722996,0
"['111001', '1', '1111010', '111', '10100', '0101000']",29,17,12,0.5862068965517241,0.4137931034482758,6,3,0.9784493292686188,0
['0'],1,0,1,0.0,1.0,0,0,-0.0,1
"['0100010', '001001', '1100']",17,6,11,0.3529411764705882,0.6470588235294118,1,4,0.9366673818775626,1
"['00011', '1111', '00011', '1110001', '101000', '010', '00100', '11', '01', '0010010']",46,21,25,0.4565217391304347,0.5434782608695652,7,9,0.994538681650011,0
"['110100', '1', '10']",9,5,4,0.5555555555555556,0.4444444444444444,2,1,0.9910760598382222,1
"['1010011', '0101', '001001', '001', '10111', '1000', '010', '10', '1']",35,17,18,0.4857142857142857,0.5142857142857142,4,6,0.9994110647387552,0
"['1', '101', '10', '00100']",11,5,6,0.4545454545454545,0.5454545454545454,2,2,0.9940302114769564,0
"['001', '110', '1', '11', '000', '000']",15,6,9,0.4,0.6,2,4,0.9709505944546686,0
"['0', '1000']",5,1,4,0.2,0.8,0,1,0.7219280948873623,1
"['0101', '1', '110']",8,5,3,0.625,0.375,2,0,0.954434002924965,1
"['00', '1001', '111', '101', '111', '10', '0010101', '101', '1011', '0111']",35,22,13,0.6285714285714286,0.3714285714285714,8,3,0.9517626756348312,0
"['01', '1000', '1010100', '0', '00101', '011111', '00001', '0101000', '101110', '110101']",49,23,26,0.4693877551020408,0.5306122448979592,5,6,0.9972943816462349,0
['00'],2,0,2,0.0,1.0,0,1,-0.0,1
"['010', '1', '1101', '01100', '10000', '1']",19,9,10,0.4736842105263157,0.5263157894736842,2,3,0.9980008838722996,1
"['0010100', '100111', '0111101']",20,11,9,0.55,0.45,3,3,0.9927744539878084,1
"['1000000', '111', '01000', '100', '10001', '1101111', '0001000', '1110', '111', '0110']",48,23,25,0.4791666666666667,0.5208333333333334,7,8,0.9987472979361685,0
"['100110', '1001', '1010000', '100', '0', '110', '00', '00010']",31,11,20,0.3548387096774194,0.6451612903225806,3,8,0.9383153522334068,0
"['01', '0111', '001111', '001']",15,9,6,0.6,0.4,3,2,0.9709505944546686,1
"['011010', '1111', '01101', '100', '000', '1', '1111', '1000']",30,17,13,0.5666666666666667,0.4333333333333333,8,3,0.9871377743721864,0
"['010', '110111', '00', '111']",14,9,5,0.6428571428571429,0.3571428571428571,3,1,0.9402859586706313,1
"['0111', '0000', '11', '11', '110111']",18,12,6,0.6666666666666666,0.3333333333333333,5,2,0.9182958340544896,0
"['000010', '110000']",12,3,9,0.25,0.75,1,4,0.8112781244591328,1
"['110011', '101']",9,6,3,0.6666666666666666,0.3333333333333333,2,1,0.9182958340544896,1
['000010'],6,1,5,0.1666666666666666,0.8333333333333334,0,2,0.6500224216483541,1
"['1', '110010', '00', '01110', '010100', '1101', '111110', '000001', '00011', '0']",42,20,22,0.4761904761904761,0.5238095238095238,7,9,0.998363672593813,0
['1101011'],7,5,2,0.7142857142857143,0.2857142857142857,2,0,0.863120568566631,1
"['101010', '110', '0', '0', '01', '00', '001011']",21,9,12,0.4285714285714285,0.5714285714285714,2,4,0.9852281360342516,0
"['1010', '1111010', '0011111', '11111', '111100', '110', '11', '1001', '0101010', '001']",48,31,17,0.6458333333333334,0.3541666666666667,11,4,0.937734293986804,0
"['11', '1101110', '0001111', '1100', '111', '1010', '0000']",31,18,13,0.5806451612903226,0.4193548387096774,8,5,0.9811522341999132,0
"['0100100', '1', '0', '0', '0011']",14,5,9,0.3571428571428571,0.6428571428571429,1,4,0.9402859586706313,0
"['100000', '10111', '10', '100', '0110101', '010', '1', '101', '1001011', '1010']",41,21,20,0.5121951219512195,0.4878048780487805,6,4,0.9995708393473224,0
"['1', '011', '11001']",9,6,3,0.6666666666666666,0.3333333333333333,2,1,0.9182958340544896,1
"['11100', '100011', '110', '1000', '1', '010010', '11', '011100', '00', '0001100']",42,19,23,0.4523809523809524,0.5476190476190477,6,8,0.9934472383802028,0
"['110111', '1011000', '0001', '0111011', '1000', '00', '11', '0010001', '1111010', '110100']",52,27,25,0.5192307692307693,0.4807692307692308,10,8,0.998932654626058,0
"['001101', '01', '100000', '0110', '00101']",23,9,14,0.391304347826087,0.6086956521739131,3,5,0.9656361333706098,1
"['0', '1101', '00101', '0110100', '01', '11010', '00111', '1000', '1100']",37,18,19,0.4864864864864865,0.5135135135135135,6,5,0.9994730201859836,0
"['0', '111', '010111', '11', '00110', '1', '00000', '10']",25,13,12,0.52,0.48,4,3,0.9988455359952018,0
"['110', '0010111', '1000', '0110']",18,9,9,0.5,0.5,4,3,1.0,1
"['01010', '111', '01010', '01', '1110', '1000', '000101', '101', '111101']",38,21,17,0.5526315789473685,0.4473684210526316,6,4,0.9919924034538556,0
"['0111110', '1101', '10', '010010', '101', '00', '111111', '11101', '10', '00']",39,24,15,0.6153846153846154,0.3846153846153846,9,4,0.961236604722876,0
"['1010001', '1100011', '0001001', '101', '01', '11110', '00000', '1']",37,17,20,0.4594594594594595,0.5405405405405406,5,7,0.9952525494396792,0
"['101', '1101', '010100', '0111110', '111000', '000', '001', '1000011']",39,19,20,0.4871794871794871,0.5128205128205128,6,7,0.999525689293649,1
['000011'],6,2,4,0.3333333333333333,0.6666666666666666,1,2,0.9182958340544896,1
"['1010111', '01', '000', '0000100', '11', '1110', '1111', '1', '0']",31,17,14,0.5483870967741935,0.4516129032258064,5,4,0.9932338197397066,0
"['11', '1000', '100', '1000', '11111', '1']",19,11,8,0.5789473684210527,0.4210526315789473,4,3,0.9819407868640976,0
"['1011', '11', '0110', '01011', '0', '001']",19,11,8,0.5789473684210527,0.4210526315789473,4,2,0.9819407868640976,0
"['001001', '0', '00111', '1', '1', '0', '1000100', '1', '1110100']",30,14,16,0.4666666666666667,0.5333333333333333,4,6,0.9967916319816366,0
"['00111', '011101']",11,7,4,0.6363636363636364,0.3636363636363636,2,1,0.94566030460064,1
"['001100', '110111', '100010', '1', '11', '0']",22,12,10,0.5454545454545454,0.4545454545454545,5,3,0.9940302114769564,0
['11'],2,2,0,1.0,0.0,1,0,-0.0,1
"['1', '1001', '10000']",10,4,6,0.4,0.6,2,3,0.9709505944546686,1
"['011', '01010', '111', '0', '1', '1011', '11110', '10']",24,16,8,0.6666666666666666,0.3333333333333333,6,0,0.9182958340544896,0
"['1', '0100', '0010111', '0101010']",19,9,10,0.4736842105263157,0.5263157894736842,1,2,0.9980008838722996,1
"['11010', '0110011', '010110', '01', '0110111', '1', '1101001', '0100001']",42,23,19,0.5476190476190477,0.4523809523809524,8,6,0.9934472383802028,0
"['0', '0100110', '00', '1', '1', '10111', '1110011', '0110110', '01']",33,19,14,0.5757575757575758,0.4242424242424242,8,5,0.9833761901392236,0
"['100', '00', '010', '1001', '0', '000101', '10', '100101', '000111']",33,13,20,0.3939393939393939,0.6060606060606061,2,7,0.9672947789468944,0
"['010', '000110', '00001', '0001100', '1001100', '01011', '00111']",38,15,23,0.3947368421052631,0.6052631578947368,5,9,0.9677884628267678,1
"['101100', '010', '0110', '0', '1', '1101', '010001', '1101']",29,15,14,0.5172413793103449,0.4827586206896552,4,4,0.9991421039919088,0
['1'],1,1,0,1.0,0.0,0,0,-0.0,1
"['0100', '00010', '0', '00', '110', '10001', '10', '11']",24,9,15,0.375,0.625,3,5,0.954434002924965,0
"['0111', '00010', '0011', '01', '0011']",19,9,10,0.4736842105263157,0.5263157894736842,3,3,0.9980008838722996,1
['00100'],5,1,4,0.2,0.8,0,2,0.7219280948873623,1
"['01110', '00', '0', '101', '100010', '0111110', '111000', '1000', '1010000']",41,18,23,0.4390243902439024,0.5609756097560976,5,8,0.9892452969285004,0
"['0010000', '011', '000110', '1011', '10', '010', '00', '0']",28,10,18,0.3571428571428571,0.6428571428571429,3,7,0.9402859586706313,0
"['1101011', '0111', '0', '0', '10', '0001', '101', '0110', '10']",28,15,13,0.5357142857142857,0.4642857142857143,5,3,0.996316519558962,0
['110'],3,2,1,0.6666666666666666,0.3333333333333333,1,0,0.9182958340544896,1
"['0010001', '10', '00', '1111111', '010', '00', '0', '11', '001101', '00101']",37,18,19,0.4864864864864865,0.5135135135135135,6,7,0.9994730201859836,0
"['0', '01111', '101', '1011', '0110001', '0', '011', '00011', '1100010']",36,19,17,0.5277777777777778,0.4722222222222222,8,5,0.997772472089982,0
"['000', '10111', '11', '0111101', '111']",20,14,6,0.7,0.3,6,1,0.8812908992306927,0
"['1', '1111', '1011', '10', '10', '11']",15,12,3,0.8,0.2,5,0,0.7219280948873623,0
"['1010111', '01100', '0001', '010111']",22,12,10,0.5454545454545454,0.4545454545454545,3,2,0.9940302114769564,1
"['11100', '011', '10010', '01', '00010', '110011', '00', '11001']",33,16,17,0.4848484848484848,0.5151515151515151,5,7,0.9993375041688848,1
['010001'],6,2,4,0.3333333333333333,0.6666666666666666,0,1,0.9182958340544896,1
"['0000', '110', '11', '0001001', '1101010', '0', '1100111', '1000010']",38,17,21,0.4473684210526316,0.5526315789473685,6,8,0.9919924034538556,0
"['1000111', '00010', '0111000', '0100000']",26,9,17,0.3461538461538461,0.6538461538461539,2,7,0.9305861291319928,1
"['011', '1101', '110', '0100011', '011', '01110']",25,15,10,0.6,0.4,6,2,0.9709505944546686,1
"['100010', '0110101', '000100', '0110', '1010', '1', '1']",29,13,16,0.4482758620689655,0.5517241379310345,3,4,0.9922666387194964,0
"['01011', '0', '011011', '001']",15,8,7,0.5333333333333333,0.4666666666666667,3,2,0.9967916319816366,1
"['001', '1', '01', '10']",8,4,4,0.5,0.5,2,1,1.0,0
"['10', '0110000']",9,3,6,0.3333333333333333,0.6666666666666666,1,3,0.9182958340544896,1
"['1101', '100', '0', '10', '00', '001', '00']",17,6,11,0.3529411764705882,0.6470588235294118,2,4,0.9366673818775626,0
"['001100', '10010', '11110', '01', '0101']",22,11,11,0.5,0.5,3,4,1.0,0
"['0101011', '101', '00', '10', '11010', '101000', '000']",28,12,16,0.4285714285714285,0.5714285714285714,2,4,0.9852281360342516,0
"['0', '01', '0100000', '01010', '0100', '11', '1111000', '100']",31,12,19,0.3870967741935484,0.6129032258064516,3,8,0.9629004147713268,0
"['11010', '11111', '0011', '101001', '1', '1111', '00001', '01011', '011', '0111000']",45,27,18,0.6,0.4,10,5,0.9709505944546686,0
"['11001', '1', '00', '110010', '0110']",18,9,9,0.5,0.5,4,4,1.0,0
"['1011001', '1100', '0', '1']",13,7,6,0.5384615384615384,0.4615384615384615,2,2,0.9957274520849256,0
"['1100111', '111', '1', '0', '1110', '110', '111110', '00', '10111']",32,23,9,0.71875,0.28125,9,2,0.8571484374283715,0
"['0', '00100', '100000', '1010000', '10', '1000000', '001101', '0001101', '111100']",47,16,31,0.3404255319148936,0.6595744680851063,4,12,0.9252253278054432,0
['1'],1,1,0,1.0,0.0,0,0,-0.0,1
"['11', '10', '101111', '111', '111']",16,14,2,0.875,0.125,6,0,0.5435644431995964,0
"['010', '1101', '111001', '001101', '11', '0', '00000']",27,13,14,0.4814814814814814,0.5185185185185185,5,5,0.9990102708804812,0
"['1101010', '1000000', '010110', '10101', '0001', '110010', '00', '1101111', '11', '01']",48,24,24,0.5,0.5,7,6,1.0,0
"['10000', '0110', '001', '1', '0101010', '1110000', '00001', '0011100', '0000110', '1']",47,18,29,0.3829787234042553,0.6170212765957447,5,11,0.9601186626422924,0
"['11010', '001101', '01', '0', '00100', '0111', '0']",24,11,13,0.4583333333333333,0.5416666666666666,3,3,0.99498482818597,0
"['111010', '100', '1101011', '111', '101', '110001', '100111', '1011101', '01100']",46,29,17,0.6304347826086957,0.3695652173913043,11,4,0.9503376699710268,0
"['1000101', '10011', '0111110', '0111011', '1000', '110100']",36,20,16,0.5555555555555556,0.4444444444444444,7,5,0.9910760598382222,1
"['11', '1111', '11', '0010', '0', '101', '00000', '001', '0111011']",31,17,14,0.5483870967741935,0.4516129032258064,6,5,0.9932338197397066,0
"['0', '01000', '10000', '001011', '01', '1110', '0100', '00', '10']",31,11,20,0.3548387096774194,0.6451612903225806,3,8,0.9383153522334068,0
"['1', '0', '10010', '1101', '0111110', '11000', '100011', '1110100', '0110111', '11']",45,27,18,0.6,0.4,9,4,0.9709505944546686,0
"['1001010', '0100100', '1101000', '1110001', '1', '1101', '1001', '101101', '1001']",47,24,23,0.5106382978723404,0.4893617021276595,8,8,0.9996734260048916,0
['000000'],6,0,6,0.0,1.0,0,3,-0.0,1
"['1111', '11', '11', '000111', '0110110', '10', '10111']",28,20,8,0.7142857142857143,0.2857142857142857,8,1,0.863120568566631,0
"['1', '1', '0010', '010', '001100', '1001', '1111', '1111', '1001']",31,18,13,0.5806451612903226,0.4193548387096774,7,6,0.9811522341999132,0
"['01001', '1001', '010', '1000', '11011', '01011']",26,13,13,0.5,0.5,4,3,1.0,0
"['11', '01110', '0101101', '1000']",18,10,8,0.5555555555555556,0.4444444444444444,4,2,0.9910760598382222,1
"['0', '01111', '110']",9,6,3,0.6666666666666666,0.3333333333333333,3,1,0.9182958340544896,1
"['0111', '1', '1101111', '101', '1110000', '001', '1010111']",32,21,11,0.65625,0.34375,9,3,0.9283620723948676,0
"['0011001', '01000', '0100101', '0']",20,7,13,0.35,0.65,1,5,0.934068055375491,1
"['1111110', '0', '1', '011000', '1110', '11', '101', '0001']",28,17,11,0.6071428571428571,0.3928571428571428,6,3,0.9666186325481028,0
"['00111', '0010', '1111', '11', '1010010', '0', '000', '1100']",30,15,15,0.5,0.5,5,6,1.0,0
"['01011', '1110', '1000']",13,7,6,0.5384615384615384,0.4615384615384615,2,1,0.9957274520849256,1
"['111', '1']",4,4,0,1.0,0.0,2,0,-0.0,0
"['11', '11', '10']",6,5,1,0.8333333333333334,0.1666666666666666,2,0,0.6500224216483541,1
"['11110', '1', '0', '10', '10011', '0010', '100', '000101', '1', '110']",31,16,15,0.5161290322580645,0.4838709677419355,5,4,0.9992492479956564,0
"['0', '001110', '1011001', '110', '11101', '1111', '011111', '000101', '010', '010000']",47,26,21,0.5531914893617021,0.4468085106382978,8,6,0.9918207974218424,0
"['0100', '1100', '0', '0', '0011001', '10', '0111000', '111', '0100']",33,14,19,0.4242424242424242,0.5757575757575758,5,8,0.9833761901392236,0
"['11111', '1', '0010110', '000', '001010', '01011', '0100111', '100000']",40,19,21,0.475,0.525,7,8,0.99819587904281,0
"['001011', '1', '1', '1101010', '00', '1', '11', '10001', '0001000']",32,15,17,0.46875,0.53125,5,5,0.9971803988942642,0
"['111000', '1101111', '0101000', '111010', '1', '101111']",33,21,12,0.6363636363636364,0.3636363636363636,8,2,0.94566030460064,0
['01'],2,1,1,0.5,0.5,0,0,1.0,1
"['11', '00', '1101011', '0', '0011010']",19,10,9,0.5263157894736842,0.4736842105263157,4,2,0.9980008838722996,0
"['0101', '111', '1111', '1100', '1000011', '00010', '111010', '110101']",39,23,16,0.5897435897435898,0.4102564102564102,8,4,0.97663491144401,0
"['01001', '10']",7,3,4,0.4285714285714285,0.5714285714285714,1,1,0.9852281360342516,1
"['00', '01101', '10', '11', '101', '00']",16,8,8,0.5,0.5,3,2,1.0,0
"['1', '010']",4,2,2,0.5,0.5,0,0,1.0,1
"['000', '0111', '10', '00', '0011110', '11', '01101', '0001', '1101']",33,17,16,0.5151515151515151,0.4848484848484848,7,5,0.9993375041688848,0
"['000010', '0101011', '01110', '011100']",24,11,13,0.4583333333333333,0.5416666666666666,3,5,0.99498482818597,1
"['0110011', '101', '0000', '10000', '00010', '00010', '00101']",34,11,23,0.3235294117647059,0.6764705882352942,2,9,0.9081783472997051,1
"['10', '101100', '111010', '10', '00', '1', '11']",21,12,9,0.5714285714285714,0.4285714285714285,3,2,0.9852281360342516,0
"['01', '1101010', '1']",10,6,4,0.6,0.4,1,0,0.9709505944546686,0
"['101111', '11011', '11111', '00', '011', '0100', '00000']",30,17,13,0.5666666666666667,0.4333333333333333,7,4,0.9871377743721864,0
"['1111110', '01111', '0', '110', '1101', '00', '10100', '01']",29,18,11,0.6206896551724138,0.3793103448275862,7,3,0.9575534837147482,0
"['101110', '00101', '00', '1011', '0', '00001', '100', '11010', '100']",34,15,19,0.4411764705882353,0.5588235294117647,4,6,0.9899927915575186,0
"['10', '01011']",7,4,3,0.5714285714285714,0.4285714285714285,1,1,0.9852281360342516,1
['101'],3,2,1,0.6666666666666666,0.3333333333333333,0,0,0.9182958340544896,1
['1'],1,1,0,1.0,0.0,0,0,-0.0,1
"['1', '01100', '1', '1', '01', '0', '101111', '00']",19,11,8,0.5789473684210527,0.4210526315789473,4,2,0.9819407868640976,0
"['0010', '0100001', '110', '100', '110011', '10', '111100', '01']",33,16,17,0.4848484848484848,0.5151515151515151,5,7,0.9993375041688848,0
['1100010'],7,3,4,0.4285714285714285,0.5714285714285714,1,1,0.9852281360342516,1
"['001111', '110', '1100', '100100', '1110', '11110', '1111110', '010', '01010', '11']",45,28,17,0.6222222222222222,0.3777777777777777,11,6,0.9564574047992594,0
"['1110010', '1011', '0001111']",18,11,7,0.6111111111111112,0.3888888888888889,4,2,0.964078764808229,1
['0011'],4,2,2,0.5,0.5,1,1,1.0,1
['0001000'],7,1,6,0.1428571428571428,0.8571428571428571,0,2,0.5916727785823275,1
"['1101', '11', '1', '011111', '001001', '0110', '011001', '10110', '10', '10000']",41,23,18,0.5609756097560976,0.4390243902439024,9,6,0.9892452969285004,0
"['00100', '0', '101', '1', '1101101']",17,9,8,0.5294117647058824,0.4705882352941176,3,2,0.9975025463691152,0
"['11', '0100', '0100', '000', '0110', '1001', '01']",23,9,14,0.391304347826087,0.6086956521739131,2,5,0.9656361333706098,0
['01001'],5,2,3,0.4,0.6,0,1,0.9709505944546686,1
"['111', '1010', '1111111', '0011', '01']",20,15,5,0.75,0.25,6,1,0.8112781244591328,0
['011010'],6,3,3,0.5,0.5,1,0,1.0,1
"['110111', '10', '0101', '1101101', '1011010', '1100']",30,19,11,0.6333333333333333,0.3666666666666666,8,2,0.9480782435939056,1
"['11', '11100']",7,5,2,0.7142857142857143,0.2857142857142857,2,1,0.863120568566631,1
"['000111', '000', '000', '1', '10000', '110111', '01']",26,11,15,0.4230769230769231,0.5769230769230769,4,6,0.9828586897127056,0
"['1010', '01110', '10', '1', '10001', '111', '1']",21,13,8,0.6190476190476191,0.3809523809523809,4,2,0.9587118829771318,0
"['0011000', '0100000']",14,3,11,0.2142857142857142,0.7857142857142857,1,5,0.74959525725948,1
['100001'],6,2,4,0.3333333333333333,0.6666666666666666,0,2,0.9182958340544896,1
"['101', '000', '11010', '111', '1', '011', '100']",21,12,9,0.5714285714285714,0.4285714285714285,4,2,0.9852281360342516,0
"['10', '01', '10', '00111', '110101', '1111']",21,14,7,0.6666666666666666,0.3333333333333333,5,2,0.9182958340544896,1
"['1110', '01']",6,4,2,0.6666666666666666,0.3333333333333333,1,1,0.9182958340544896,1
"['1010', '1001', '10', '10011']",15,8,7,0.5333333333333333,0.4666666666666667,2,2,0.9967916319816366,0
"['011', '1001', '010']",10,5,5,0.5,0.5,1,1,1.0,1
['0000000'],7,0,7,0.0,1.0,0,3,-0.0,1
"['1', '0', '100010']",8,3,5,0.375,0.625,0,1,0.954434002924965,0
"['101', '01']",5,3,2,0.6,0.4,0,0,0.9709505944546686,1
"['0010', '1011010', '100', '000111']",20,9,11,0.45,0.55,2,3,0.9927744539878084,1
"['10110', '0010101', '0111101', '100110', '0111100', '1000', '100000', '0001', '1']",47,22,25,0.4680851063829787,0.5319148936170213,8,9,0.9970590569034106,0
"['1011110', '1110011', '1100100', '100', '001', '1010', '1101111']",38,23,15,0.6052631578947368,0.3947368421052631,9,5,0.9677884628267678,1
"['11001', '1111', '1100', '010000', '11', '001100', '111', '01001', '1001101', '111']",45,26,19,0.5777777777777777,0.4222222222222222,11,8,0.9824740868386408,0
"['100', '0000', '11', '001000', '011', '010']",21,7,14,0.3333333333333333,0.6666666666666666,2,6,0.9182958340544896,1
"['01101', '10011', '1011111', '00', '110110', '11', '010000', '10', '11110', '0110']",44,26,18,0.5909090909090909,0.4090909090909091,11,5,0.9760206482366148,0
"['11110', '1111', '010010', '0', '000000', '11', '00110', '0', '0100001', '10111']",42,20,22,0.4761904761904761,0.5238095238095238,8,9,0.998363672593813,0
"['1', '10100', '00', '101001', '000010', '110', '000111', '000', '101101', '10']",40,17,23,0.425,0.575,5,8,0.983708262623186,0
"['0101000', '00001', '01', '1', '010', '01', '11001', '10010']",30,12,18,0.4,0.6,3,6,0.9709505944546686,0
"['01101', '1001', '11011', '10', '1101', '1', '10110', '11', '00']",30,19,11,0.6333333333333333,0.3666666666666666,8,2,0.9480782435939056,0
"['1001', '1', '1001']",9,5,4,0.5555555555555556,0.4444444444444444,1,2,0.9910760598382222,1
"['01101', '000101', '01110', '111', '01000', '0011001', '1010', '00111', '0011', '00']",46,22,24,0.4782608695652174,0.5217391304347826,7,7,0.9986359641585718,0
"['0101010', '10110', '10001', '010', '0111']",24,12,12,0.5,0.5,2,2,1.0,1
"['1101', '0', '101000', '0111111', '0', '100', '1']",23,13,10,0.5652173913043478,0.4347826086956521,4,3,0.9876925088958034,0
"['1', '101', '00111', '1011011', '01', '100', '1', '011110', '001101', '1001000']",41,23,18,0.5609756097560976,0.4390243902439024,10,5,0.9892452969285004,0
"['0', '1000']",5,1,4,0.2,0.8,0,1,0.7219280948873623,1
"['10', '0', '01001', '1011', '00010']",17,7,10,0.4117647058823529,0.5882352941176471,2,3,0.9774178175281716,0
['01110'],5,3,2,0.6,0.4,1,0,0.9709505944546686,1
"['01110', '0010', '1000', '111', '0', '0100', '011']",24,11,13,0.4583333333333333,0.5416666666666666,3,4,0.99498482818597,0
"['111', '0110', '0', '01000', '0111101', '10', '1111010', '111', '11']",34,22,12,0.6470588235294118,0.3529411764705882,9,3,0.9366673818775626,0
['1'],1,1,0,1.0,0.0,0,0,-0.0,1
"['00100', '010', '11', '11010', '000010', '0', '1010', '011', '010000', '01']",37,14,23,0.3783783783783784,0.6216216216216216,3,8,0.9568886656798212,0
"['1101', '0010', '000', '0011101', '1100101', '1101', '1000']",33,16,17,0.4848484848484848,0.5151515151515151,5,6,0.9993375041688848,1
"['01', '01101', '010', '01', '001', '11010', '1100010', '0000001', '1110000', '1']",42,18,24,0.4285714285714285,0.5714285714285714,5,8,0.9852281360342516,0
"['101', '100', '1', '1', '1001']",12,7,5,0.5833333333333334,0.4166666666666667,2,2,0.9798687566511528,0
"['10001', '00', '111', '11', '001', '0101', '1110', '1101101']",30,18,12,0.6,0.4,6,3,0.9709505944546686,0
"['00111', '1000', '1', '1001010', '1', '110', '110011', '0101', '0001110']",38,20,18,0.5263157894736842,0.4736842105263157,7,5,0.9980008838722996,0
"['001', '011', '1']",7,4,3,0.5714285714285714,0.4285714285714285,1,1,0.9852281360342516,1
"['000', '11', '1', '11100', '0', '1111111', '11101', '010', '1111110']",34,24,10,0.7058823529411765,0.2941176470588235,11,2,0.8739810481273578,0
"['11', '00101']",7,4,3,0.5714285714285714,0.4285714285714285,1,1,0.9852281360342516,1
"['0', '101101', '011', '11001', '101']",18,11,7,0.6111111111111112,0.3888888888888889,4,1,0.964078764808229,0
"['0001101', '1111101', '111', '1101']",21,15,6,0.7142857142857143,0.2857142857142857,7,1,0.863120568566631,0
"['0', '00001', '1', '00111']",12,5,7,0.4166666666666667,0.5833333333333334,2,3,0.9798687566511528,0
"['0010', '0010011', '00', '00000', '11', '0001110', '0010001', '100001', '01011']",45,16,29,0.3555555555555555,0.6444444444444445,5,11,0.9389320105807948,0
"['010', '10', '000', '000101', '010110', '1']",21,8,13,0.3809523809523809,0.6190476190476191,1,3,0.9587118829771318,0
"['01', '0001', '0', '01', '100110', '000']",18,6,12,0.3333333333333333,0.6666666666666666,2,5,0.9182958340544896,0
"['011', '00110', '100100', '01', '110', '1']",20,10,10,0.5,0.5,3,3,1.0,0
"['100001', '00', '1']",9,3,6,0.3333333333333333,0.6666666666666666,0,3,0.9182958340544896,0
"['10100', '00', '101', '0']",11,4,7,0.3636363636363636,0.6363636363636364,0,2,0.94566030460064,0
"['0', '011', '1001', '1', '0', '1101']",14,8,6,0.5714285714285714,0.4285714285714285,3,2,0.9852281360342516,0
"['000110', '100010', '011010', '101', '1', '10101', '00111']",32,16,16,0.5,0.5,4,4,1.0,0
"['11', '110', '0110010', '010', '1']",16,9,7,0.5625,0.4375,3,3,0.9886994082884974,0
"['00100', '1101101', '0110']",16,8,8,0.5,0.5,3,2,1.0,1
"['11', '0001111', '01000', '0110101', '00100']",26,12,14,0.4615384615384615,0.5384615384615384,4,5,0.9957274520849256,1
"['0', '11100']",6,3,3,0.5,0.5,1,1,1.0,1
"['000', '10', '0000000', '101', '00100', '1001000', '0', '1110', '00001']",37,10,27,0.2702702702702703,0.7297297297297297,1,12,0.8418521897563207,0
"['1011010', '01']",9,5,4,0.5555555555555556,0.4444444444444444,1,1,0.9910760598382222,1
['1011000'],7,3,4,0.4285714285714285,0.5714285714285714,1,1,0.9852281360342516,1
"['0', '01011', '101', '0100', '00001', '1', '0101']",23,10,13,0.4347826086956521,0.5652173913043478,2,4,0.9876925088958034,0
['11'],2,2,0,1.0,0.0,1,0,-0.0,1
"['10100', '0', '1000010', '111010', '00101', '111111', '010010']",36,18,18,0.5,0.5,4,5,1.0,0
"['0111', '0011111', '0111', '1', '1101010', '11', '10101', '101011', '1011', '1100']",44,30,14,0.6818181818181818,0.3181818181818182,11,2,0.9023932827949788,0
"['0111', '000001', '10', '0101', '1000110', '01', '0']",26,11,15,0.4230769230769231,0.5769230769230769,4,5,0.9828586897127056,0
"['0111011', '100110', '1111', '0101', '01', '1011101', '00010']",35,21,14,0.6,0.4,7,2,0.9709505944546686,0
"['0011101', '1101', '01010', '01010', '00', '001011', '001', '11101', '0011110', '0']",45,23,22,0.5111111111111111,0.4888888888888889,7,7,0.999643749677856,0
"['001', '1', '000100', '11']",12,5,7,0.4166666666666667,0.5833333333333334,2,3,0.9798687566511528,0
"['01', '1010', '10001', '0110001', '011001', '111', '00110', '1111001']",39,21,18,0.5384615384615384,0.4615384615384615,8,5,0.9957274520849256,0
"['101', '010110', '1100', '0', '01100', '00', '10', '100']",26,11,15,0.4230769230769231,0.5769230769230769,3,5,0.9828586897127056,0
"['0', '010011', '01010']",12,5,7,0.4166666666666667,0.5833333333333334,1,2,0.9798687566511528,1
"['1010', '0010010', '10', '1000', '001', '11', '001', '001111']",31,14,17,0.4516129032258064,0.5483870967741935,3,6,0.9932338197397066,0
"['011010', '00', '10', '1010', '011110', '0100010', '111010', '0010', '00110', '1011']",46,22,24,0.4782608695652174,0.5217391304347826,6,6,0.9986359641585718,0
"['111', '1100', '00', '01', '10']",13,7,6,0.5384615384615384,0.4615384615384615,3,2,0.9957274520849256,1
['00100'],5,1,4,0.2,0.8,0,2,0.7219280948873623,1
"['0', '1110']",5,3,2,0.6,0.4,1,0,0.9709505944546686,1
['10'],2,1,1,0.5,0.5,0,0,1.0,1
"['00', '0110', '0000', '10011', '1100100']",22,8,14,0.3636363636363636,0.6363636363636364,3,6,0.94566030460064,0
"['00111', '01000']",10,4,6,0.4,0.6,1,2,0.9709505944546686,1
"['010010', '1']",7,3,4,0.4285714285714285,0.5714285714285714,0,1,0.9852281360342516,1
"['1', '0101001', '101100', '01011', '1', '10111', '10010', '100', '10']",35,19,16,0.5428571428571428,0.4571428571428571,6,4,0.9946937953613058,0
"['011', '00']",5,2,3,0.4,0.6,1,1,0.9709505944546686,1
"['1', '011101', '0101', '01111']",16,11,5,0.6875,0.3125,3,0,0.8960382325345574,1
"['000', '101100']",9,3,6,0.3333333333333333,0.6666666666666666,1,2,0.9182958340544896,1
"['0111001', '011110', '101010', '11111', '11', '010000', '1111']",36,23,13,0.6388888888888888,0.3611111111111111,8,3,0.943601631299382,0
['0'],1,0,1,0.0,1.0,0,0,-0.0,1
"['101', '101100', '111', '00', '00', '100', '0101101', '01']",28,14,14,0.5,0.5,4,4,1.0,0
"['11', '111']",5,5,0,1.0,0.0,2,0,-0.0,0
['10'],2,1,1,0.5,0.5,0,0,1.0,1
"['111', '0111', '00']",9,6,3,0.6666666666666666,0.3333333333333333,2,1,0.9182958340544896,1
"['1100000', '000', '01101', '11011', '11111']",25,14,11,0.56,0.44,6,4,0.9895875212220556,1
"['1', '1', '0', '11', '0']",6,4,2,0.6666666666666666,0.3333333333333333,2,0,0.9182958340544896,0
"['00001', '1111100', '0111', '011001', '01110', '1', '01111']",33,20,13,0.6060606060606061,0.3939393939393939,8,4,0.9672947789468944,0
"['10', '10111', '11', '0110', '01', '00']",17,10,7,0.5882352941176471,0.4117647058823529,3,2,0.9774178175281716,0
"['1', '0101100', '00', '011110', '0001001', '0', '1000000', '11', '01', '10']",37,15,22,0.4054054054054054,0.5945945945945946,5,8,0.974024864435752,0
"['00', '1110010', '101', '111', '011', '1']",19,12,7,0.631578947368421,0.3684210526315789,4,2,0.9494520153879484,0
"['1100101', '1110010', '0100', '101', '00101', '000001']",32,14,18,0.4375,0.5625,3,7,0.9886994082884974,1
"['00111', '1010000', '0010001', '000', '0', '00001', '0111111', '0']",36,14,22,0.3888888888888889,0.6111111111111112,5,9,0.964078764808229,0
"['0000101', '111010', '10011', '0111', '10101']",27,15,12,0.5555555555555556,0.4444444444444444,5,3,0.9910760598382222,1
"['00', '111', '101', '01']",10,6,4,0.6,0.4,2,1,0.9709505944546686,1
['011'],3,2,1,0.6666666666666666,0.3333333333333333,1,0,0.9182958340544896,1
['010011'],6,3,3,0.5,0.5,1,1,1.0,1
"['0111', '1', '0011']",9,6,3,0.6666666666666666,0.3333333333333333,3,1,0.9182958340544896,1
"['0', '001111', '000000', '10', '0110']",19,7,12,0.3684210526315789,0.631578947368421,3,5,0.9494520153879484,0
"['110111', '0', '100000', '00', '0', '0000']",20,6,14,0.3,0.7,2,6,0.8812908992306927,0
"['1', '1110', '011']",8,6,2,0.75,0.25,3,1,0.8112781244591328,0
"['10', '11111', '10111', '1', '1', '11', '111', '1011111', '010', '000']",32,24,8,0.75,0.25,10,2,0.8112781244591328,0
"['0100', '10', '11000', '0110', '111010']",21,10,11,0.4761904761904761,0.5238095238095238,3,3,0.998363672593813,1
"['1', '011101', '01010', '10010', '100100', '0', '000', '100', '0101000', '001']",40,15,25,0.375,0.625,1,8,0.954434002924965,0
"['0000', '00101', '00', '01001', '10', '00', '0100000', '0101000']",34,8,26,0.2352941176470588,0.7647058823529411,1,11,0.7871265862012691,0
"['0010000', '0', '1', '1011', '010', '011', '1', '0', '0110100']",28,12,16,0.4285714285714285,0.5714285714285714,4,6,0.9852281360342516,0
"['1', '00100', '010010', '1101100', '0100', '111', '10011', '10101', '11001', '1100010']",48,24,24,0.5,0.5,7,8,1.0,0
"['10101', '10']",7,4,3,0.5714285714285714,0.4285714285714285,1,0,0.9852281360342516,1
"['1011011', '10', '00', '0111011', '0', '10', '00', '11101', '1001110', '111']",38,23,15,0.6052631578947368,0.3947368421052631,8,4,0.9677884628267678,0
"['0101101', '10111']",12,8,4,0.6666666666666666,0.3333333333333333,3,0,0.9182958340544896,1
"['1', '011']",4,3,1,0.75,0.25,1,0,0.8112781244591328,1
"['0100', '100', '000100']",13,3,10,0.2307692307692307,0.7692307692307693,0,4,0.7793498372920851,1
"['0110110', '011', '100']",13,7,6,0.5384615384615384,0.4615384615384615,3,2,0.9957274520849256,1
"['001101', '0110', '001100', '1011001', '0111', '0011110', '1010', '101']",41,22,19,0.5365853658536586,0.4634146341463415,7,5,0.9961344835095796,1
"['1111', '1', '1', '111', '1']",10,10,0,1.0,0.0,5,0,-0.0,0
"['10', '1001', '010000', '1010111', '11011']",24,13,11,0.5416666666666666,0.4583333333333333,3,3,0.99498482818597,1
"['00', '100', '0', '10', '1001', '00', '01', '1100110']",23,9,14,0.391304347826087,0.6086956521739131,2,5,0.9656361333706098,0
"['0', '111', '1', '010', '1110001']",15,9,6,0.6,0.4,3,1,0.9709505944546686,0
"['001', '1001', '1', '0100', '1', '0100']",17,7,10,0.4117647058823529,0.5882352941176471,2,4,0.9774178175281716,0
"['011110', '00100', '1100', '01011', '01000']",25,11,14,0.44,0.56,4,4,0.9895875212220556,1
"['01000', '10111', '1', '11', '0011100', '01', '00', '0111010', '11110', '10100']",41,22,19,0.5365853658536586,0.4634146341463415,7,5,0.9961344835095796,0
"['110101', '00111', '00', '01101', '00', '0', '0', '000', '0111111', '1010110']",39,20,19,0.5128205128205128,0.4871794871794871,7,6,0.999525689293649,0
"['1010', '1101001', '01100', '0']",17,8,9,0.4705882352941176,0.5294117647058824,2,2,0.9975025463691152,1
"['0100111', '010', '11100', '100001', '101', '1', '0', '110000', '100', '0000111']",42,19,23,0.4523809523809524,0.5476190476190477,6,9,0.9934472383802028,0
"['1110000', '101', '10', '0', '110101']",19,10,9,0.5263157894736842,0.4736842105263157,3,3,0.9980008838722996,0
"['0', '000', '01101', '1', '010', '1010']",17,7,10,0.4117647058823529,0.5882352941176471,2,2,0.9774178175281716,0
"['1101011', '011010', '11111', '010', '01', '11', '0', '0111']",30,20,10,0.6666666666666666,0.3333333333333333,7,2,0.9182958340544896,0
"['001', '10001', '1000', '10010', '010111', '010', '00', '00']",30,11,19,0.3666666666666666,0.6333333333333333,3,7,0.9480782435939056,0
"['110', '10', '1110001', '00001', '11000', '1']",23,11,12,0.4782608695652174,0.5217391304347826,3,4,0.9986359641585718,0
"['1', '000', '001010', '1111111', '1101', '00010', '000', '01', '11111', '001111']",42,24,18,0.5714285714285714,0.4285714285714285,9,6,0.9852281360342516,0
"['1001111', '101100', '1100000', '0', '00', '1111111', '1010', '00']",36,19,17,0.5277777777777778,0.4722222222222222,8,7,0.997772472089982,0
['11'],2,2,0,1.0,0.0,1,0,-0.0,1
"['10', '011000', '111011']",14,8,6,0.5714285714285714,0.4285714285714285,3,2,0.9852281360342516,1
"['1110010', '10100', '11110', '110', '00101', '1']",26,15,11,0.5769230769230769,0.4230769230769231,5,3,0.9828586897127056,0
"['1', '1010', '0101']",9,5,4,0.5555555555555556,0.4444444444444444,1,1,0.9910760598382222,0
['1011'],4,3,1,0.75,0.25,1,0,0.8112781244591328,1
"['111', '0110', '1', '0', '11', '1100000', '0', '1', '011']",23,13,10,0.5652173913043478,0.4347826086956521,5,3,0.9876925088958034,0
"['0110', '1110']",8,5,3,0.625,0.375,2,0,0.954434002924965,1
"['0', '11', '1', '0', '01', '1110']",11,7,4,0.6363636363636364,0.3636363636363636,3,1,0.94566030460064,0
"['0', '00111', '1', '000000']",13,4,9,0.3076923076923077,0.6923076923076923,2,4,0.8904916402194913,0
"['101110', '01', '111', '001011', '0101111', '1001', '0111', '100001', '001010']",44,25,19,0.5681818181818182,0.4318181818181818,8,6,0.9865446300055644,0
"['0011010', '01011']",12,6,6,0.5,0.5,2,2,1.0,1
"['111', '1111', '1', '010111', '1', '011001', '010101', '1', '100000']",34,21,13,0.6176470588235294,0.3823529411764705,8,3,0.9596868937742168,0
"['10', '011110', '1', '11', '1010111', '001001']",24,15,9,0.625,0.375,5,3,0.954434002924965,0
"['0100101', '0', '1001', '0', '0000010', '11', '01111']",27,12,15,0.4444444444444444,0.5555555555555556,3,5,0.9910760598382222,0
"['0110000', '10010', '10', '0100011', '1110', '0011', '1000000', '0']",37,14,23,0.3783783783783784,0.6216216216216216,4,9,0.9568886656798212,0
['0'],1,0,1,0.0,1.0,0,0,-0.0,1
"['000', '10', '011001', '01', '01100', '0110', '000', '0']",26,9,17,0.3461538461538461,0.6538461538461539,3,6,0.9305861291319928,0
"['10', '01', '101001', '1100101', '0001000', '00001', '10', '0110']",35,14,21,0.4,0.6,4,8,0.9709505944546686,0
"['111', '011', '1010', '11111', '0000', '0100', '1100', '111', '01']",32,19,13,0.59375,0.40625,6,4,0.9744894033980523,0
"['0110100', '10001', '100', '1000']",19,7,12,0.3684210526315789,0.631578947368421,2,4,0.9494520153879484,1
"['111110', '110001', '01', '10', '0', '010', '011']",23,13,10,0.5652173913043478,0.4347826086956521,5,3,0.9876925088958034,0
"['0110', '0001001', '010101', '11', '1', '1001']",24,12,12,0.5,0.5,3,4,1.0,0
"['1001', '0100100', '011011', '11', '10', '1110']",25,14,11,0.56,0.44,4,3,0.9895875212220556,0
"['110', '1100', '0110110', '1010', '010111', '01111', '0111101', '111110', '10111']",47,32,15,0.6808510638297872,0.3191489361702128,13,2,0.9034535552068336,0
"['0010', '01', '0101010']",13,5,8,0.3846153846153846,0.6153846153846154,0,2,0.961236604722876,1
"['1', '10011', '1110101', '010100']",19,11,8,0.5789473684210527,0.4210526315789473,3,2,0.9819407868640976,1
"['1', '110', '0100101', '00100', '10', '0010100', '1000', '110', '0011011', '1001']",43,19,24,0.4418604651162791,0.5581395348837209,4,9,0.9902246902198684,0
"['001001', '0', '0001110', '101011', '0']",21,9,12,0.4285714285714285,0.5714285714285714,2,4,0.9852281360342516,1
"['1010001', '0001001', '000', '1', '0', '101', '01110']",27,11,16,0.4074074074074074,0.5925925925925926,1,4,0.975119064940866,0
"['11', '0']",3,2,1,0.6666666666666666,0.3333333333333333,1,0,0.9182958340544896,1
"['0001101', '0101010', '101', '0010']",21,9,12,0.4285714285714285,0.5714285714285714,1,2,0.9852281360342516,1
"['1', '1110101']",8,6,2,0.75,0.25,2,0,0.8112781244591328,1
"['111001', '10100', '11000', '010101', '011']",25,13,12,0.52,0.48,4,4,0.9988455359952018,1
"['101', '1100', '111', '1']",11,8,3,0.7272727272727273,0.2727272727272727,3,1,0.8453509366224364,0
"['1100', '101011', '1000', '000', '11', '00110', '11011', '110', '0110']",36,19,17,0.5277777777777778,0.4722222222222222,8,6,0.997772472089982,0
"['1011', '0', '10', '1000', '0010', '11101']",20,10,10,0.5,0.5,2,2,1.0,0
"['110', '011']",6,4,2,0.6666666666666666,0.3333333333333333,2,1,0.9182958340544896,1
['0010'],4,1,3,0.25,0.75,0,1,0.8112781244591328,1
"['001', '00', '001', '110', '00', '100010', '1', '100', '011']",26,10,16,0.3846153846153846,0.6153846153846154,3,6,0.961236604722876,0
"['001101', '1111111', '001', '10', '001110']",24,15,9,0.625,0.375,7,3,0.954434002924965,1
"['00001', '1001100', '11', '0']",15,6,9,0.4,0.6,3,4,0.9709505944546686,0
"['0', '0100', '10', '00101', '11010', '100', '1011100', '01010', '1110100', '110001']",45,21,24,0.4666666666666667,0.5333333333333333,4,7,0.9967916319816366,0
"['0110010', '01', '0101', '0001011', '111', '1', '00010', '010101']",35,17,18,0.4857142857142857,0.5142857142857142,4,5,0.9994110647387552,0
"['00010', '01', '11', '1101011', '0', '11111']",22,14,8,0.6363636363636364,0.3636363636363636,5,2,0.94566030460064,0
"['00000', '10', '0', '0000100', '11111', '101', '010010', '11']",31,13,18,0.4193548387096774,0.5806451612903226,4,7,0.9811522341999132,0
"['001100', '10', '111', '110111', '0', '11110', '111']",26,18,8,0.6923076923076923,0.3076923076923077,7,2,0.8904916402194913,0
"['00', '01', '0', '01', '1', '011110', '10', '10', '100010', '0100']",28,12,16,0.4285714285714285,0.5714285714285714,3,5,0.9852281360342516,0
"['011', '10', '10', '11', '010']",12,7,5,0.5833333333333334,0.4166666666666667,2,0,0.9798687566511528,1
"['1011011', '1111000', '10', '101']",19,12,7,0.631578947368421,0.3684210526315789,4,1,0.9494520153879484,1
"['111010', '00010', '11', '0011010', '0101101', '100111']",33,18,15,0.5454545454545454,0.4545454545454545,6,5,0.9940302114769564,1
"['011', '1010111']",10,7,3,0.7,0.3,2,0,0.8812908992306927,1
"['00110', '0011', '1010', '10', '1111']",19,11,8,0.5789473684210527,0.4210526315789473,4,2,0.9819407868640976,0
"['101', '1100', '101100', '00000', '01001', '1']",24,10,14,0.4166666666666667,0.5833333333333334,3,6,0.9798687566511528,1
"['100111', '011000', '1000', '1', '00000', '010', '1000', '010110']",35,13,22,0.3714285714285714,0.6285714285714286,3,8,0.9517626756348312,0
"['11100', '0']",6,3,3,0.5,0.5,1,1,1.0,1
"['0011001', '11', '1101011', '1111']",20,14,6,0.7,0.3,6,2,0.8812908992306927,0
"['0111000', '11']",9,5,4,0.5555555555555556,0.4444444444444444,2,1,0.9910760598382222,1
"['1', '11101', '011001']",12,8,4,0.6666666666666666,0.3333333333333333,3,1,0.9182958340544896,1
"['101001', '0', '110111', '110']",16,10,6,0.625,0.375,3,1,0.954434002924965,1
"['11', '101', '0010']",9,5,4,0.5555555555555556,0.4444444444444444,1,1,0.9910760598382222,1
"['0010000', '00', '0001100', '1111100', '1', '1', '1', '0011']",30,13,17,0.4333333333333333,0.5666666666666667,5,8,0.9871377743721864,0
"['100000', '00100', '01', '0', '010010', '0']",21,5,16,0.238095238095238,0.7619047619047619,0,7,0.7918583525674836,0
"['00110', '010111', '1100111', '001101']",24,14,10,0.5833333333333334,0.4166666666666667,5,4,0.9798687566511528,1
"['00', '0110', '01', '11110']",13,7,6,0.5384615384615384,0.4615384615384615,3,2,0.9957274520849256,1
"['1100', '10', '0', '10101', '00', '001', '0010010', '1100111', '0', '1011']",36,17,19,0.4722222222222222,0.5277777777777778,4,7,0.997772472089982,0
"['0000', '100011', '100', '100000', '1']",20,6,14,0.3,0.7,1,6,0.8812908992306927,1
"['1110', '000010', '11111', '1', '00111', '1', '10000']",27,15,12,0.5555555555555556,0.4444444444444444,6,5,0.9910760598382222,0
"['00011', '01010', '111', '110010', '010', '1110', '0110110', '011']",36,20,16,0.5555555555555556,0.4444444444444444,7,5,0.9910760598382222,0
"['0000001', '1010100']",14,4,10,0.2857142857142857,0.7142857142857143,1,4,0.863120568566631,1
"['0001', '0011010', '1011110', '1', '101']",22,12,10,0.5454545454545454,0.4545454545454545,4,2,0.9940302114769564,0
"['0', '11101', '100', '01110', '1000101']",21,11,10,0.5238095238095238,0.4761904761904761,3,2,0.998363672593813,0
"['1100', '1001', '111', '00', '11', '1001000', '101', '0100', '11100']",34,17,17,0.5,0.5,5,7,1.0,0
"['10001', '1']",6,3,3,0.5,0.5,1,1,1.0,1
"['111', '000100', '010']",12,5,7,0.4166666666666667,0.5833333333333334,1,2,0.9798687566511528,1
"['11011', '100011', '110', '11110', '0010', '01000', '010100', '0', '1110111']",42,23,19,0.5476190476190477,0.4523809523809524,8,6,0.9934472383802028,0
"['1', '111', '01001', '110', '0000011', '000101', '1110', '0111111', '0']",37,21,16,0.5675675675675675,0.4324324324324324,9,6,0.9867867202680318,0
"['001', '0001000', '01001']",15,4,11,0.2666666666666666,0.7333333333333333,0,5,0.8366407419411672,1
"['0001', '1000000', '111000', '1011', '111101', '1000011', '00', '0100', '0100', '011']",47,20,27,0.425531914893617,0.574468085106383,8,10,0.9839393951635756,0
"['11', '010011', '0', '10', '1100', '10111']",20,12,8,0.6,0.4,4,2,0.9709505944546686,0
"['01110', '0011010', '11', '01010', '111010']",25,14,11,0.56,0.44,4,1,0.9895875212220556,1
['010'],3,1,2,0.3333333333333333,0.6666666666666666,0,0,0.9182958340544896,1
"['10110', '01', '1011010', '11000']",19,10,9,0.5263157894736842,0.4736842105263157,4,2,0.9980008838722996,1
"['10', '1', '00', '0110111', '011101']",18,11,7,0.6111111111111112,0.3888888888888889,3,1,0.964078764808229,0
"['00000', '100', '111110', '0111001', '101101', '0', '0', '00000', '0']",35,14,21,0.4,0.6,5,9,0.9709505944546686,0
"['100010', '1', '110010']",13,6,7,0.4615384615384615,0.5384615384615384,1,2,0.9957274520849256,1
"['101101', '1000', '011110', '0101101', '0000']",27,13,14,0.4814814814814814,0.5185185185185185,5,5,0.9990102708804812,1
"['1', '10001', '111110']",12,8,4,0.6666666666666666,0.3333333333333333,4,1,0.9182958340544896,1
"['10100', '001001', '01', '00111', '1']",19,9,10,0.4736842105263157,0.5263157894736842,2,4,0.9980008838722996,0
"['1', '1100001', '001', '11101', '0', '010', '011011', '1011011', '1010001', '011011']",46,26,20,0.5652173913043478,0.4347826086956521,9,6,0.9876925088958034,0
"['0', '10', '100', '101010', '1', '100', '0']",17,7,10,0.4117647058823529,0.5882352941176471,1,2,0.9774178175281716,0
"['0', '00001', '11', '1000101', '0', '010110', '0011', '10001', '1100011']",38,17,21,0.4473684210526316,0.5526315789473685,6,7,0.9919924034538556,0
"['111100', '00', '111']",11,7,4,0.6363636363636364,0.3636363636363636,3,2,0.94566030460064,1
"['001', '00', '110', '0100111', '0010111', '10', '0010011', '010', '00', '1']",37,17,20,0.4594594594594595,0.5405405405405406,5,8,0.9952525494396792,0
"['1100110', '0', '0111111', '01', '0000', '1001', '1110', '0110', '0001010']",40,20,20,0.5,0.5,8,8,1.0,0
"['010', '100', '0', '0101111', '10110', '11001']",24,13,11,0.5416666666666666,0.4583333333333333,4,3,0.99498482818597,0
"['00100', '1110011', '11']",14,8,6,0.5714285714285714,0.4285714285714285,3,3,0.9852281360342516,1
"['1101100', '11']",9,6,3,0.6666666666666666,0.3333333333333333,3,1,0.9182958340544896,1
"['011011', '110', '100', '0001010', '0111', '1011', '111110', '1110010', '1']",41,25,16,0.6097560975609756,0.3902439024390244,9,4,0.9649567669505684,0
"['1110', '011', '000000', '0001001', '0', '0100110', '010000']",34,11,23,0.3235294117647059,0.6764705882352942,3,11,0.9081783472997051,0
"['0000011', '111', '0', '101', '0', '1', '01', '0', '110']",22,11,11,0.5,0.5,3,2,1.0,0
"['001000', '11', '10000', '1110', '001100']",23,9,14,0.391304347826087,0.6086956521739131,3,6,0.9656361333706098,1
['11'],2,2,0,1.0,0.0,1,0,-0.0,1
"['00011', '0', '10', '110011', '101100', '0']",21,10,11,0.4761904761904761,0.5238095238095238,4,3,0.998363672593813,1
"['1110', '110011', '011']",13,9,4,0.6923076923076923,0.3076923076923077,4,1,0.8904916402194913,1
"['01000', '0010']",9,2,7,0.2222222222222222,0.7777777777777778,0,2,0.7642045065086203,1
"['1000111', '1', '1110101', '1110110']",22,15,7,0.6818181818181818,0.3181818181818182,6,1,0.9023932827949788,1
"['1001011', '100', '10', '010']",15,7,8,0.4666666666666667,0.5333333333333333,1,3,0.9967916319816366,0
"['00000', '100010', '0100111']",18,6,12,0.3333333333333333,0.6666666666666666,1,5,0.9182958340544896,1
"['0111', '0', '10101', '100110', '0100101', '0', '010', '0011', '01']",33,16,17,0.4848484848484848,0.5151515151515151,4,5,0.9993375041688848,0
"['01', '10', '0011110', '100110', '101000']",23,11,12,0.4782608695652174,0.5217391304347826,4,3,0.9986359641585718,0
"['0', '011101', '1100']",11,6,5,0.5454545454545454,0.4545454545454545,2,2,0.9940302114769564,1
"['0110', '00', '11', '111101', '0110']",18,11,7,0.6111111111111112,0.3888888888888889,5,1,0.964078764808229,1
"['101', '1', '111100']",10,7,3,0.7,0.3,3,1,0.8812908992306927,1
"['11001', '101110']",11,7,4,0.6363636363636364,0.3636363636363636,3,1,0.94566030460064,1
"['1100101', '10', '111', '01', '1', '1011110', '1101', '01111']",31,22,9,0.7096774193548387,0.2903225806451613,9,1,0.869137580612638,0
"['110000', '0011100', '000', '0010000', '001111', '101', '0111000', '0', '10011']",45,18,27,0.4,0.6,6,12,0.9709505944546686,0
['1'],1,1,0,1.0,0.0,0,0,-0.0,1
"['1111011', '11', '010001', '10', '0100110', '00001', '11100', '1101101']",41,23,18,0.5609756097560976,0.4390243902439024,10,6,0.9892452969285004,1
"['01001', '1010100', '011', '111', '1100110', '100', '11001']",33,18,15,0.5454545454545454,0.4545454545454545,6,5,0.9940302114769564,1
"['0011001', '11', '001010', '111', '100', '010', '11', '1', '00111', '10100']",37,20,17,0.5405405405405406,0.4594594594594595,7,6,0.9952525494396792,0
"['110', '01001', '1111', '000011', '00000', '0110', '1']",28,13,15,0.4642857142857143,0.5357142857142857,5,7,0.996316519558962,0
"['0', '110', '010001', '10', '1', '1100010', '11110', '0101100', '1100', '0']",37,18,19,0.4864864864864865,0.5135135135135135,7,6,0.9994730201859836,0
['00110'],5,2,3,0.4,0.6,1,1,0.9709505944546686,1
"['01100', '1']",6,3,3,0.5,0.5,1,1,1.0,1
['0111111'],7,6,1,0.8571428571428571,0.1428571428571428,3,0,0.5916727785823275,1
"['110010', '1', '011101', '001111']",19,12,7,0.631578947368421,0.3684210526315789,4,2,0.9494520153879484,1
"['11000', '001001', '110', '10', '111101', '111001']",28,16,12,0.5714285714285714,0.4285714285714285,6,4,0.9852281360342516,1
"['0011', '0101011', '0100001', '1', '10']",21,10,11,0.4761904761904761,0.5238095238095238,3,3,0.998363672593813,0
"['0101', '01', '0', '010001', '1000010', '0', '01010', '0111010', '0']",34,13,21,0.3823529411764705,0.6176470588235294,2,7,0.9596868937742168,0
"['10', '110111', '010000']",14,7,7,0.5,0.5,2,2,1.0,1
"['0101100', '011']",10,5,5,0.5,0.5,2,1,1.0,1
"['1000', '011000']",10,3,7,0.3,0.7,1,3,0.8812908992306927,1
"['1', '000100', '101', '11', '101110', '01000', '00011', '010011']",34,16,18,0.4705882352941176,0.5294117647058824,5,7,0.9975025463691152,0
"['11101', '10001', '00011', '1', '1', '1011', '101010', '1111', '01']",33,21,12,0.6363636363636364,0.3636363636363636,7,2,0.94566030460064,0
"['010', '101', '0000001', '1000000']",20,5,15,0.25,0.75,1,6,0.8112781244591328,1
"['1001', '1010100', '101', '11101', '0110111', '01101']",31,19,12,0.6129032258064516,0.3870967741935484,6,2,0.9629004147713268,0
['1101010'],7,4,3,0.5714285714285714,0.4285714285714285,1,0,0.9852281360342516,1
"['1101100', '0001', '111', '00']",16,8,8,0.5,0.5,4,3,1.0,1
['101011'],6,4,2,0.6666666666666666,0.3333333333333333,1,0,0.9182958340544896,1
['110010'],6,3,3,0.5,0.5,1,1,1.0,1
"['0001', '0110', '0', '10010', '1001', '11', '1000', '1001']",28,12,16,0.4285714285714285,0.5714285714285714,3,6,0.9852281360342516,0
"['111110', '11111', '0001101']",18,13,5,0.7222222222222222,0.2777777777777778,5,1,0.8524051786494786,1
"['00010', '01', '010110', '01110']",18,8,10,0.4444444444444444,0.5555555555555556,2,3,0.9910760598382222,1
"['0011100', '1', '11111', '10100', '0', '001001', '0001111']",32,17,15,0.53125,0.46875,6,6,0.9971803988942642,0
"['110110', '110', '001', '0101', '111011']",22,14,8,0.6363636363636364,0.3636363636363636,6,1,0.94566030460064,0
"['1001011', '010', '010', '1', '1001', '0111', '10100', '1011', '1']",32,18,14,0.5625,0.4375,5,4,0.9886994082884974,0
"['0', '111', '1000010', '000']",14,5,9,0.3571428571428571,0.6428571428571429,2,4,0.9402859586706313,0
"['10', '10111', '0000', '0', '1110', '0000011', '01', '10']",27,12,15,0.4444444444444444,0.5555555555555556,4,5,0.9910760598382222,0
"['11011', '0', '1', '11110', '0', '110100', '111']",22,15,7,0.6818181818181818,0.3181818181818182,6,2,0.9023932827949788,0
"['10010', '10100', '000', '0']",14,4,10,0.2857142857142857,0.7142857142857143,0,4,0.863120568566631,0
"['00100', '1000', '1001111']",16,7,9,0.4375,0.5625,2,4,0.9886994082884974,1
"['0100', '0001', '11001', '1100000', '110', '0100000', '000100', '1010', '0001']",44,14,30,0.3181818181818182,0.6818181818181818,3,13,0.9023932827949788,0
"['1110001', '0', '000111', '010']",17,8,9,0.4705882352941176,0.5294117647058824,2,3,0.9975025463691152,0
"['11000', '111']",8,5,3,0.625,0.375,2,1,0.954434002924965,1
"['11110', '111010', '000011', '011011', '100']",26,15,11,0.5769230769230769,0.4230769230769231,6,3,0.9828586897127056,1
"['0101110', '11', '0', '11111', '001100', '010', '0', '01100', '100']",33,17,16,0.5151515151515151,0.4848484848484848,6,5,0.9993375041688848,0
"['1111', '000', '010', '11', '1', '10110']",18,11,7,0.6111111111111112,0.3888888888888889,5,2,0.964078764808229,0
"['010', '1111011', '10011', '1', '1', '0', '010', '10010']",26,15,11,0.5769230769230769,0.4230769230769231,5,3,0.9828586897127056,0
"['1000011', '0']",8,3,5,0.375,0.625,1,2,0.954434002924965,1
"['111000', '11', '01', '101', '01000', '0']",19,9,10,0.4736842105263157,0.5263157894736842,3,3,0.9980008838722996,0
"['001', '10000', '1', '0111', '010111', '000100', '101', '011100', '1000001']",41,18,23,0.4390243902439024,0.5609756097560976,4,8,0.9892452969285004,0
['1101000'],7,3,4,0.4285714285714285,0.5714285714285714,1,1,0.9852281360342516,1
"['00', '1']",3,1,2,0.3333333333333333,0.6666666666666666,0,1,0.9182958340544896,1
"['1', '100']",4,2,2,0.5,0.5,1,1,1.0,1
"['0011111', '000', '111101', '110']",19,12,7,0.631578947368421,0.3684210526315789,5,2,0.9494520153879484,1
"['010011', '1101', '0']",11,6,5,0.5454545454545454,0.4545454545454545,2,1,0.9940302114769564,1
"['1101', '00010']",9,4,5,0.4444444444444444,0.5555555555555556,1,1,0.9910760598382222,1
"['100', '1', '0', '1', '0111110', '1011']",17,11,6,0.6470588235294118,0.3529411764705882,3,1,0.9366673818775626,0
"['110', '100']",6,3,3,0.5,0.5,1,1,1.0,1
"['11', '000']",5,2,3,0.4,0.6,1,1,0.9709505944546686,1
"['101110', '0011', '11111', '0', '1001', '11000', '0010']",29,16,13,0.5517241379310345,0.4482758620689655,5,4,0.9922666387194964,0
"['0', '100', '0110', '00', '00', '1000', '001', '000', '000101']",28,7,21,0.25,0.75,1,8,0.8112781244591328,0
"['00', '0101', '100', '101110', '11111', '1', '1', '010001', '1']",29,17,12,0.5862068965517241,0.4137931034482758,6,3,0.9784493292686188,0
"['1011100', '01000', '101', '00', '100', '011']",23,10,13,0.4347826086956521,0.5652173913043478,2,4,0.9876925088958034,1
"['1100010', '1101111', '00', '1', '111011']",23,15,8,0.6521739130434783,0.3478260869565217,7,2,0.9321115676166748,0
"['00100', '1001101', '0101']",16,7,9,0.4375,0.5625,1,3,0.9886994082884974,1
"['010111', '001011', '1001101', '10', '0', '0', '1100001']",30,15,15,0.5,0.5,5,5,1.0,0
['1101100'],7,4,3,0.5714285714285714,0.4285714285714285,2,1,0.9852281360342516,1
"['1001001', '111', '1', '1000', '0']",16,8,8,0.5,0.5,3,4,1.0,0
"['0011', '0000', '01', '1000100', '1110111', '0010001', '10001', '010']",39,16,23,0.4102564102564102,0.5897435897435898,5,8,0.97663491144401,0
"['1100', '11', '0111', '11', '1100', '0011011', '1', '0', '000001', '10010']",36,19,17,0.5277777777777778,0.4722222222222222,8,7,0.997772472089982,0
"['1', '1001', '00', '111', '0100100', '100000', '110011', '1', '10']",32,15,17,0.46875,0.53125,5,7,0.9971803988942642,0
"['100111', '11', '0', '1', '10', '0110001']",19,11,8,0.5789473684210527,0.4210526315789473,4,3,0.9819407868640976,0
['1110'],4,3,1,0.75,0.25,1,0,0.8112781244591328,1
"['0', '101', '0110000', '1011', '110', '0001011', '010']",28,13,15,0.4642857142857143,0.5357142857142857,4,4,0.996316519558962,0
"['10', '101', '1111111', '0100', '1111', '11111']",25,20,5,0.8,0.2,8,1,0.7219280948873623,0
"['1000000', '1']",8,2,6,0.25,0.75,0,3,0.8112781244591328,1
"['001001', '1', '101000']",13,5,8,0.3846153846153846,0.6153846153846154,1,3,0.961236604722876,1
"['111', '011', '1101001', '11', '11', '11', '011011', '111']",28,22,6,0.7857142857142857,0.2142857142857142,9,1,0.74959525725948,0
"['1001', '1001100', '000', '101011', '10110', '0111']",29,15,14,0.5172413793103449,0.4827586206896552,5,5,0.9991421039919088,1
"['0011111', '10001', '000', '00', '001000', '11', '0011000', '10110', '000000']",43,15,28,0.3488372093023256,0.6511627906976745,6,11,0.9330252953592912,0
"['1100010', '0101110', '0011101', '1000101', '00', '11', '101110', '000110', '01', '0001001']",53,25,28,0.4716981132075472,0.5283018867924528,7,10,0.9976875760352552,0
"['101110', '1010010', '1111', '1100', '0000', '0010']",29,14,15,0.4827586206896552,0.5172413793103449,4,5,0.9991421039919088,1
"['0100', '11', '101', '010']",12,6,6,0.5,0.5,1,1,1.0,1
"['1', '0111', '111110', '00101', '000001', '1']",23,13,10,0.5652173913043478,0.4347826086956521,5,3,0.9876925088958034,0
"['10', '11']",4,3,1,0.75,0.25,1,0,0.8112781244591328,1
"['1011000', '100010', '0011', '1101011', '00', '0', '00', '10011', '0']",35,15,20,0.4285714285714285,0.5714285714285714,5,6,0.9852281360342516,0
['100'],3,1,2,0.3333333333333333,0.6666666666666666,0,1,0.9182958340544896,1
"['0', '1100', '10101', '11111', '10', '110']",20,13,7,0.65,0.35,5,1,0.934068055375491,0
['10'],2,1,1,0.5,0.5,0,0,1.0,1
"['1', '11', '1001011', '00', '01110', '001010', '1000001', '0001', '101', '1001']",41,19,22,0.4634146341463415,0.5365853658536586,6,7,0.9961344835095796,0
"['10', '00110', '0111001', '010110', '1001110', '1', '1010', '0', '11']",35,19,16,0.5428571428571428,0.4571428571428571,6,5,0.9946937953613058,0
"['0001', '000111', '011101', '0001']",20,9,11,0.45,0.55,2,3,0.9927744539878084,1
"['01', '00', '0010']",8,2,6,0.25,0.75,0,2,0.8112781244591328,1
"['010100', '11001', '1111', '1111100', '0110100', '1110111', '10000', '101000', '0101001', '0110']",58,31,27,0.5344827586206896,0.4655172413793103,11,9,0.9965663713274552,1
"['10', '000110', '0', '10100', '00', '00', '110100', '0', '101001', '1001110']",38,15,23,0.3947368421052631,0.6052631578947368,4,9,0.9677884628267678,0
"['1010', '0101111', '0']",12,7,5,0.5833333333333334,0.4166666666666667,2,1,0.9798687566511528,1
"['111101', '00110', '10', '1101011', '0111']",24,16,8,0.6666666666666666,0.3333333333333333,6,1,0.9182958340544896,1
['011101'],6,4,2,0.6666666666666666,0.3333333333333333,1,0,0.9182958340544896,1
"['0010010', '1111', '010010', '101', '011', '00100']",28,13,15,0.4642857142857143,0.5357142857142857,3,5,0.996316519558962,0
"['01', '110001', '0010', '0101111', '100111', '0100', '000000', '01']",37,16,21,0.4324324324324324,0.5675675675675675,4,8,0.9867867202680318,1
"['1100010', '1000', '10001', '00', '1', '1101', '011011', '0011', '010']",36,17,19,0.4722222222222222,0.5277777777777778,5,5,0.997772472089982,0
"['001001', '001', '101000', '01', '0', '1', '1111011', '0111', '11']",32,18,14,0.5625,0.4375,6,5,0.9886994082884974,0
"['1101', '100', '0001', '0', '1', '0', '001', '011010', '010', '11']",28,13,15,0.4642857142857143,0.5357142857142857,4,4,0.996316519558962,0
"['001', '010001', '10', '1']",12,5,7,0.4166666666666667,0.5833333333333334,1,2,0.9798687566511528,0
"['10001', '1', '1010', '0', '111111']",17,11,6,0.6470588235294118,0.3529411764705882,4,2,0.9366673818775626,0
"['1', '0001', '11000', '0000', '1', '1111111', '0', '10']",25,13,12,0.52,0.48,5,4,0.9988455359952018,0
"['000100', '1001101', '1100', '001111', '10', '001', '01', '1010', '0']",35,16,19,0.4571428571428571,0.5428571428571428,5,7,0.9946937953613058,0
"['100', '1100011', '1001111', '1', '011000', '0111110', '001111', '0']",38,22,16,0.5789473684210527,0.4210526315789473,9,6,0.9819407868640976,0
"['0100001', '1111', '0000', '10010']",20,8,12,0.4,0.6,2,5,0.9709505944546686,1
"['0110101', '101111', '10001', '0100', '0000110', '010']",32,15,17,0.46875,0.53125,5,5,0.9971803988942642,1
"['1100100', '0111', '0', '1100', '000']",19,8,11,0.4210526315789473,0.5789473684210527,3,4,0.9819407868640976,0
"['01110', '1101', '011110', '11111', '0011', '0001001', '010', '101', '1011']",41,25,16,0.6097560975609756,0.3902439024390244,9,3,0.9649567669505684,0
"['110', '00', '0100011']",12,5,7,0.4166666666666667,0.5833333333333334,2,3,0.9798687566511528,1
"['0100110', '01000', '1', '0010010', '0011110', '10111']",32,15,17,0.46875,0.53125,4,6,0.9971803988942642,1
"['10', '1001', '00', '00']",10,3,7,0.3,0.7,0,3,0.8812908992306927,1
"['1000', '011100', '01100', '0', '0', '1111100', '11', '10', '111001']",34,18,16,0.5294117647058824,0.4705882352941176,6,7,0.9975025463691152,0
"['1000', '0', '1', '10010', '000000', '01000', '1', '010']",26,7,19,0.2692307692307692,0.7307692307692307,1,8,0.8403586716091171,0
"['011011', '1010', '1', '0100000', '1']",19,9,10,0.4736842105263157,0.5263157894736842,2,2,0.9980008838722996,1
"['0100000', '0010001']",14,3,11,0.2142857142857142,0.7857142857142857,0,4,0.74959525725948,1
"['010', '011', '111000', '100010', '0', '11', '1', '1100111', '0']",30,16,14,0.5333333333333333,0.4666666666666667,5,5,0.9967916319816366,0
"['1', '00', '110101']",9,5,4,0.5555555555555556,0.4444444444444444,1,1,0.9910760598382222,1
"['0100', '01', '0', '11', '0011', '100100']",19,8,11,0.4210526315789473,0.5789473684210527,2,4,0.9819407868640976,0
"['0101', '01011', '1']",10,6,4,0.6,0.4,1,0,0.9709505944546686,0
"['111', '111101', '011', '0', '000011', '000010', '00010', '1111100']",37,19,18,0.5135135135135135,0.4864864864864865,7,7,0.9994730201859836,0
"['00', '000011', '1', '010', '0']",13,4,9,0.3076923076923077,0.6923076923076923,1,4,0.8904916402194913,0
"['1100111', '11', '0001', '0']",14,8,6,0.5714285714285714,0.4285714285714285,3,2,0.9852281360342516,1
"['01000', '1', '1', '1', '011', '11101', '0011', '01', '0100', '00']",28,14,14,0.5,0.5,4,4,1.0,0
"['10', '01', '110', '10', '001000', '1101', '0101', '1111']",27,15,12,0.5555555555555556,0.4444444444444444,4,3,0.9910760598382222,0
"['001000', '1100111', '0110110', '00010', '0110000', '1', '1101100', '110010', '1']",47,22,25,0.4680851063829787,0.5319148936170213,8,10,0.9970590569034106,0
"['00', '001110', '1011', '110', '011110', '1111101']",28,18,10,0.6428571428571429,0.3571428571428571,7,3,0.9402859586706313,1
"['0001', '0100010', '0001001', '101110', '111']",27,12,15,0.4444444444444444,0.5555555555555556,3,5,0.9910760598382222,1
"['00', '101001', '11001', '1111100', '101', '0']",24,13,11,0.5416666666666666,0.4583333333333333,4,4,0.99498482818597,0
"['10011', '01000']",10,4,6,0.4,0.6,1,2,0.9709505944546686,1
"['00', '0000000', '1011010', '1', '1010', '00', '1', '0000', '000110', '11']",36,12,24,0.3333333333333333,0.6666666666666666,4,8,0.9182958340544896,0
"['110000', '0100', '01', '000001', '1101011', '10', '111']",30,14,16,0.4666666666666667,0.5333333333333333,4,5,0.9967916319816366,1
"['101', '01', '11011', '01101', '110100', '010', '10010']",29,16,13,0.5517241379310345,0.4482758620689655,4,2,0.9922666387194964,0
"['01110', '0000011', '000', '10', '11110', '0010', '111', '1111', '0111011']",40,23,17,0.575,0.425,9,5,0.983708262623186,0
"['001', '110101', '1101']",13,8,5,0.6153846153846154,0.3846153846153846,2,1,0.961236604722876,1
"['11001', '100', '00', '1000']",14,5,9,0.3571428571428571,0.6428571428571429,2,4,0.9402859586706313,1
"['01000', '1011110', '01', '1100', '11111', '1', '00010', '000100', '0000101']",42,19,23,0.4523809523809524,0.5476190476190477,6,9,0.9934472383802028,0
"['101', '0011110', '0010100', '01', '1001010', '0101', '1101', '1', '01101']",40,21,19,0.525,0.475,6,5,0.99819587904281,0
"['1', '0010', '1000', '0001010']",16,5,11,0.3125,0.6875,0,4,0.8960382325345574,1
"['10100', '1', '011100', '110', '111001', '1']",22,13,9,0.5909090909090909,0.4090909090909091,4,3,0.9760206482366148,0
"['0111001', '10', '1', '11', '00', '01', '1011010', '0000', '0111']",31,16,15,0.5161290322580645,0.4838709677419355,6,5,0.9992492479956564,0
['10101'],5,3,2,0.6,0.4,0,0,0.9709505944546686,1
"['1101', '01100', '100000', '110', '10111']",23,12,11,0.5217391304347826,0.4782608695652174,4,3,0.9986359641585718,1
"['1', '011', '0110', '101']",11,7,4,0.6363636363636364,0.3636363636363636,2,0,0.94566030460064,0
"['100110', '1001', '11111', '1']",16,11,5,0.6875,0.3125,4,2,0.8960382325345574,0
"['10011', '00101', '001', '1']",14,7,7,0.5,0.5,2,3,1.0,0
"['0100', '110010', '1', '00011', '0', '10', '110', '0010', '11']",28,13,15,0.4642857142857143,0.5357142857142857,4,4,0.996316519558962,0
"['1', '0101']",5,3,2,0.6,0.4,0,0,0.9709505944546686,1
"['00101', '001000', '1100', '11', '11011', '001111', '101010', '110001', '000111']",46,24,22,0.5217391304347826,0.4782608695652174,8,7,0.9986359641585718,0
"['0111', '0000', '00', '0000101', '1111100', '100001', '0001011', '101']",40,17,23,0.425,0.575,5,9,0.983708262623186,0
"['00', '11001', '011', '1100101', '00111']",22,12,10,0.5454545454545454,0.4545454545454545,4,4,0.9940302114769564,1
['1110011'],7,5,2,0.7142857142857143,0.2857142857142857,2,1,0.863120568566631,1
"['10001', '1001', '11110', '00']",16,8,8,0.5,0.5,3,3,1.0,1
"['1001', '1010100', '01101', '1100100']",23,11,12,0.4782608695652174,0.5217391304347826,3,4,0.9986359641585718,1
"['0', '10100', '00', '10001', '0000', '111001', '110101', '1101011']",36,17,19,0.4722222222222222,0.5277777777777778,4,6,0.997772472089982,0
"['101', '0', '1010100', '1', '00010']",17,7,10,0.4117647058823529,0.5882352941176471,0,2,0.9774178175281716,0
"['111100', '000', '001', '0', '010', '1101', '00', '1111']",26,13,13,0.5,0.5,5,5,1.0,0
"['1000011', '0011011', '11000', '1000', '00', '101010', '0100000', '00']",40,14,26,0.35,0.65,4,10,0.934068055375491,1
"['1100111', '100101', '011000']",19,10,9,0.5263157894736842,0.4736842105263157,4,3,0.9980008838722996,1
"['1', '10', '111', '1', '011', '11', '10000', '0001']",21,12,9,0.5714285714285714,0.4285714285714285,5,3,0.9852281360342516,0
"['111', '01']",5,4,1,0.8,0.2,1,0,0.7219280948873623,1
"['000010', '0']",7,1,6,0.1428571428571428,0.8571428571428571,0,3,0.5916727785823275,1
['0'],1,0,1,0.0,1.0,0,0,-0.0,1
"['011', '01111', '0011', '001011', '10', '11', '1100010', '110110']",35,21,14,0.6,0.4,9,3,0.9709505944546686,0
"['00010', '11', '100101', '0010100', '10001', '0']",26,10,16,0.3846153846153846,0.6153846153846154,1,5,0.961236604722876,0
"['01', '01110', '1010', '10011', '0110', '100110', '1101111', '111', '000001', '1101011']",49,29,20,0.5918367346938775,0.4081632653061224,10,4,0.9755259511264972,0
"['0101', '0', '001010', '0001', '010111']",21,9,12,0.4285714285714285,0.5714285714285714,1,3,0.9852281360342516,0
"['00', '1', '001111', '00101', '1010', '011011', '1', '110', '1110100']",35,20,15,0.5714285714285714,0.4285714285714285,7,5,0.9852281360342516,0
"['0111', '100', '101', '0', '100', '1111', '00', '00000', '100110']",31,14,17,0.4516129032258064,0.5483870967741935,5,6,0.9932338197397066,0
"['0101', '1110', '111010', '00', '00', '1111001', '001', '00101', '1010010', '11011']",45,24,21,0.5333333333333333,0.4666666666666667,8,6,0.9967916319816366,0
"['0001000', '1110000', '1000', '0111001', '1011101', '111110', '1001', '1101']",46,24,22,0.5217391304347826,0.4782608695652174,8,8,0.9986359641585718,1
"['0111010', '1101', '10', '1', '0000', '111001']",24,13,11,0.5416666666666666,0.4583333333333333,4,3,0.99498482818597,0
"['11110', '10111', '10110', '010', '110']",21,14,7,0.6666666666666666,0.3333333333333333,6,1,0.9182958340544896,1
"['10', '010', '10', '0', '1111001', '01001', '01110', '011000', '01', '11']",35,18,17,0.5142857142857142,0.4857142857142857,5,7,0.9994110647387552,0
"['0110001', '0111', '1011111']",18,12,6,0.6666666666666666,0.3333333333333333,5,1,0.9182958340544896,1
"['11', '010111', '10000']",13,7,6,0.5384615384615384,0.4615384615384615,3,2,0.9957274520849256,1
"['1', '10110', '01000', '1']",12,6,6,0.5,0.5,2,2,1.0,1
"['1001010', '11000', '110', '10', '10011', '0', '0000011', '0', '110', '0000']",38,15,23,0.3947368421052631,0.6052631578947368,5,8,0.9677884628267678,0
"['1011110', '010', '00001', '1', '000000', '0000', '1', '01', '0111100', '001']",39,15,24,0.3846153846153846,0.6153846153846154,5,10,0.961236604722876,0
"['00011', '1', '000']",9,3,6,0.3333333333333333,0.6666666666666666,1,2,0.9182958340544896,0
"['1', '100', '0', '0', '10', '10001', '01', '1000']",19,7,12,0.3684210526315789,0.631578947368421,2,4,0.9494520153879484,0
"['001', '1101', '1', '0011100', '111', '0']",19,11,8,0.5789473684210527,0.4210526315789473,4,3,0.9819407868640976,0
"['1000100', '001', '0110000', '0', '01', '1']",21,7,14,0.3333333333333333,0.6666666666666666,2,6,0.9182958340544896,0
"['11110', '01011', '1001111', '10']",19,13,6,0.6842105263157895,0.3157894736842105,5,2,0.8997437586982626,1
"['0', '01010', '110', '1111', '1', '101011', '00', '100', '0100111']",32,18,14,0.5625,0.4375,6,4,0.9886994082884974,0
"['0', '0', '111', '01', '10']",9,5,4,0.5555555555555556,0.4444444444444444,2,1,0.9910760598382222,0
"['0', '101', '0110011', '0101', '110001']",21,11,10,0.5238095238095238,0.4761904761904761,3,2,0.998363672593813,0
"['11', '0010110', '11']",11,7,4,0.6363636363636364,0.3636363636363636,3,1,0.94566030460064,1
"['101', '01110', '0000110', '1', '10111', '000']",24,12,12,0.5,0.5,4,3,1.0,0
"['01100', '111011', '0010']",15,8,7,0.5333333333333333,0.4666666666666667,3,2,0.9967916319816366,1
"['010', '11', '000001']",11,4,7,0.3636363636363636,0.6363636363636364,1,2,0.94566030460064,1
"['11', '01', '01', '10111']",11,8,3,0.7272727272727273,0.2727272727272727,3,0,0.8453509366224364,1
"['1101', '11001', '100']",12,7,5,0.5833333333333334,0.4166666666666667,3,2,0.9798687566511528,1
"['100', '00', '010001', '001110', '1000100', '111001', '0001001', '100000', '01', '10']",47,17,30,0.3617021276595745,0.6382978723404256,4,12,0.9440870182837794,0
"['10', '0', '010010', '11111', '0101000', '1', '10001', '110110']",33,17,16,0.5151515151515151,0.4848484848484848,5,4,0.9993375041688848,0
"['00', '1', '100011']",9,4,5,0.4444444444444444,0.5555555555555556,2,2,0.9910760598382222,1
['1100110'],7,4,3,0.5714285714285714,0.4285714285714285,2,1,0.9852281360342516,1
"['001000', '001111', '1', '1001000', '0011010', '1100000', '0110']",38,15,23,0.3947368421052631,0.6052631578947368,6,9,0.9677884628267678,0
"['1110011', '1101', '00101', '01010', '000', '10', '1101', '0']",31,16,15,0.5161290322580645,0.4838709677419355,4,4,0.9992492479956564,0
"['0010', '1000', '0001', '011', '1111110', '11', '1011010']",31,17,14,0.5483870967741935,0.4516129032258064,6,4,0.9932338197397066,0
"['00', '011101', '1010', '1', '1010110']",20,11,9,0.55,0.45,4,1,0.9927744539878084,1
"['1', '011', '10101', '000', '10001', '1']",18,9,9,0.5,0.5,2,2,1.0,0
"['101000', '00', '1', '00', '000101', '01010', '11011']",27,11,16,0.4074074074074074,0.5925925925925926,2,4,0.975119064940866,0
"['101', '1']",4,3,1,0.75,0.25,1,0,0.8112781244591328,1
"['11110', '10110']",10,7,3,0.7,0.3,3,0,0.8812908992306927,1
"['00101', '0110000', '0110010', '00', '1000100', '11011', '10010', '1', '11000', '0']",45,18,27,0.4,0.6,5,10,0.9709505944546686,0
"['000100', '000001', '011', '10', '1111', '1']",22,10,12,0.4545454545454545,0.5454545454545454,3,4,0.9940302114769564,0
"['1101100', '01100', '1000000', '1111111', '1000']",30,15,15,0.5,0.5,7,6,1.0,1
['0'],1,0,1,0.0,1.0,0,0,-0.0,1
"['101101', '00010', '00000', '0110001', '00101', '01', '1101101', '11001', '010110', '101']",51,24,27,0.4705882352941176,0.5294117647058824,6,7,0.9975025463691152,0
"['10110', '111000', '010', '11000', '0100', '1101100', '1010101', '000', '0110111', '0111110']",54,28,26,0.5185185185185185,0.4814814814814814,9,8,0.9990102708804812,1
"['010', '011']",6,3,3,0.5,0.5,1,1,1.0,1
"['1000111', '0010000', '0011', '00', '10', '1000000', '1001', '1', '011010']",40,15,25,0.375,0.625,4,10,0.954434002924965,0
"['101', '00110', '01100']",13,6,7,0.4615384615384615,0.5384615384615384,2,3,0.9957274520849256,1
"['101111', '1110', '00']",12,8,4,0.6666666666666666,0.3333333333333333,3,1,0.9182958340544896,1
"['111000', '001111', '000', '10', '0111001']",24,12,12,0.5,0.5,4,5,1.0,1
"['0001010', '1', '01', '1', '000001', '111', '10', '01', '1', '11100']",30,15,15,0.5,0.5,5,5,1.0,0
"['0', '0']",2,0,2,0.0,1.0,0,1,-0.0,1
"['100110', '0100', '1', '01101', '0110101', '1', '1110001', '0', '00000']",37,17,20,0.4594594594594595,0.5405405405405406,5,7,0.9952525494396792,0
"['00011', '000', '10', '101']",13,5,8,0.3846153846153846,0.6153846153846154,1,2,0.961236604722876,1
"['101', '0', '10011', '10110', '101', '000110']",23,12,11,0.5217391304347826,0.4782608695652174,3,2,0.9986359641585718,1
"['1111000', '10', '1010111', '001', '0101101', '1000010']",33,17,16,0.5151515151515151,0.4848484848484848,5,4,0.9993375041688848,1
"['0', '0', '0010', '01', '0', '010001']",15,4,11,0.2666666666666666,0.7333333333333333,0,5,0.8366407419411672,0
"['000010', '1', '10', '0010', '100', '0001100', '0101101']",30,11,19,0.3666666666666666,0.6333333333333333,3,6,0.9480782435939056,0
"['001011', '01111', '01', '101', '0000111', '1', '1']",25,15,10,0.6,0.4,6,3,0.9709505944546686,0
"['01', '1010', '0', '1000100', '010', '11', '0001']",23,9,14,0.391304347826087,0.6086956521739131,2,4,0.9656361333706098,0
"['011', '000', '01010']",11,4,7,0.3636363636363636,0.6363636363636364,1,2,0.94566030460064,1
"['10', '1011', '101010', '011110', '1', '0100', '100011', '111000', '011100', '0011']",45,24,21,0.5333333333333333,0.4666666666666667,7,7,0.9967916319816366,0
"['1001', '000', '1', '1101', '0100', '00']",18,7,11,0.3888888888888889,0.6111111111111112,1,4,0.964078764808229,0
['010101'],6,3,3,0.5,0.5,0,0,1.0,1
"['111101', '10001', '00', '11011', '0000', '1100101', '0']",30,15,15,0.5,0.5,6,5,1.0,0
"['1100010', '11111', '01', '1011110', '1101', '1111']",29,21,8,0.7241379310344828,0.2758620689655172,9,1,0.8497511372532974,0
"['0', '0', '000', '1111001', '01010', '00010', '01', '10']",26,10,16,0.3846153846153846,0.6153846153846154,3,6,0.961236604722876,0
"['001110', '0', '0', '101011', '1101000']",21,10,11,0.4761904761904761,0.5238095238095238,3,3,0.998363672593813,1
"['0000', '00101', '000110', '01']",17,5,12,0.2941176470588235,0.7058823529411765,1,5,0.8739810481273578,1
"['10010', '00', '1000', '111', '100', '1001111', '0010', '110', '00']",33,15,18,0.4545454545454545,0.5454545454545454,5,7,0.9940302114769564,0
['00010'],5,1,4,0.2,0.8,0,1,0.7219280948873623,1
"['1110101', '01']",9,6,3,0.6666666666666666,0.3333333333333333,1,0,0.9182958340544896,1
"['1', '11100', '1', '0001011', '00', '0111', '0110']",24,13,11,0.5416666666666666,0.4583333333333333,5,3,0.99498482818597,0
"['0111000', '10010', '11000', '110', '001', '11', '1011101', '01110', '1100000']",44,22,22,0.5,0.5,8,6,1.0,0
"['000', '1100', '100010', '1']",14,5,9,0.3571428571428571,0.6428571428571429,1,3,0.9402859586706313,1
"['00', '0110', '0011000', '11', '0011101', '0100', '1']",27,12,15,0.4444444444444444,0.5555555555555556,4,5,0.9910760598382222,0
"['1', '10011', '11011', '0', '0', '011001', '1100110', '1']",27,16,11,0.5925925925925926,0.4074074074074074,7,4,0.975119064940866,0
"['10', '010', '011100', '01011', '10']",18,9,9,0.5,0.5,2,3,1.0,1
"['11001', '0010', '001001']",15,6,9,0.4,0.6,1,4,0.9709505944546686,1
"['11', '0111', '1011', '11', '11', '1010010', '000100']",27,16,11,0.5925925925925926,0.4074074074074074,6,4,0.975119064940866,1
"['011', '0', '1001110', '1', '0010', '100111', '0', '1010011', '110', '001110']",39,21,18,0.5384615384615384,0.4615384615384615,6,5,0.9957274520849256,0
"['01111', '101']",8,6,2,0.75,0.25,2,0,0.8112781244591328,1
"['001000', '111000', '111', '001010', '001', '0000001', '000110', '011']",40,15,25,0.375,0.625,4,10,0.954434002924965,1
"['100', '1001001', '11']",12,6,6,0.5,0.5,1,3,1.0,1
"['01', '1110', '11110']",11,8,3,0.7272727272727273,0.2727272727272727,4,0,0.8453509366224364,1
"['1', '1111', '1', '011111', '110011', '010000', '11011', '1000101', '00', '10001']",43,25,18,0.5813953488372093,0.4186046511627907,9,6,0.9807983646944296,0
"['011011', '1011', '11', '1101000', '1101', '010', '1001010', '110', '0111']",40,24,16,0.6,0.4,8,3,0.9709505944546686,0
"['00', '000', '0110111', '0101001', '01', '1']",22,10,12,0.4545454545454545,0.5454545454545454,3,4,0.9940302114769564,0
"['001110', '10100']",11,5,6,0.4545454545454545,0.5454545454545454,1,2,0.9940302114769564,1
"['001', '10001', '011111']",14,8,6,0.5714285714285714,0.4285714285714285,3,2,0.9852281360342516,1
"['1111100', '00', '10011', '1', '00', '1010000', '1011', '1110111']",35,20,15,0.5714285714285714,0.4285714285714285,6,6,0.9852281360342516,0
['11'],2,2,0,1.0,0.0,1,0,-0.0,1
"['000110', '001011', '1101', '0', '1', '1000100', '0', '0101101']",33,15,18,0.4545454545454545,0.5454545454545454,5,5,0.9940302114769564,0
['100001'],6,2,4,0.3333333333333333,0.6666666666666666,0,2,0.9182958340544896,1
['00'],2,0,2,0.0,1.0,0,1,-0.0,1
"['011', '100000', '001']",12,4,8,0.3333333333333333,0.6666666666666666,1,3,0.9182958340544896,1
"['11', '0011111', '0']",10,7,3,0.7,0.3,3,1,0.8812908992306927,1
['0010'],4,1,3,0.25,0.75,0,1,0.8112781244591328,1
"['00', '001']",5,1,4,0.2,0.8,0,2,0.7219280948873623,1
['11'],2,2,0,1.0,0.0,1,0,-0.0,1
"['00', '1001', '111', '0010', '10', '1101', '1100110']",26,14,12,0.5384615384615384,0.4615384615384615,5,4,0.9957274520849256,0
"['01', '1100011', '0', '111', '1011101', '100000', '001101', '11']",34,19,15,0.5588235294117647,0.4411764705882353,8,4,0.9899927915575186,0
"['0111', '0101', '100']",11,6,5,0.5454545454545454,0.4545454545454545,2,1,0.9940302114769564,1
"['011', '001', '10001', '000', '01', '0', '101', '0010001']",27,10,17,0.3703703703703703,0.6296296296296297,2,6,0.9509560484549724,0
"['1', '001', '100', '10', '1111011', '100', '0010']",23,12,11,0.5217391304347826,0.4782608695652174,4,4,0.9986359641585718,0
"['00110', '101', '100010', '1', '11010', '000', '01', '100', '00', '110']",33,14,19,0.4242424242424242,0.5757575757575758,5,6,0.9833761901392236,0
"['100101', '110111', '0100', '010000', '0', '1011000', '100101', '110']",39,18,21,0.4615384615384615,0.5384615384615384,4,6,0.9957274520849256,0
"['11', '00000', '11001', '001', '11110', '011', '01001', '00']",30,14,16,0.4666666666666667,0.5333333333333333,5,7,0.9967916319816366,0
"['0101011', '11', '1111010', '0', '010', '0011110', '001']",30,17,13,0.5666666666666667,0.4333333333333333,6,3,0.9871377743721864,0
"['101110', '011001', '101', '0101', '101', '01000']",27,14,13,0.5185185185185185,0.4814814814814814,4,3,0.9990102708804812,1
"['111100', '010111', '11', '10', '10']",18,12,6,0.6666666666666666,0.3333333333333333,5,1,0.9182958340544896,1
"['1001100', '100001', '10', '1011000', '1010']",26,11,15,0.4230769230769231,0.5769230769230769,3,5,0.9828586897127056,0
"['0', '111100', '11100', '0', '1111', '0000', '011']",24,13,11,0.5416666666666666,0.4583333333333333,6,4,0.99498482818597,0
"['0100010', '11100', '00001', '01011', '001101', '0', '0', '0']",31,12,19,0.3870967741935484,0.6129032258064516,3,6,0.9629004147713268,1
['000111'],6,3,3,0.5,0.5,1,1,1.0,1
"['110', '0', '01000', '110', '10', '0', '1100', '0010', '1']",24,10,14,0.4166666666666667,0.5833333333333334,3,5,0.9798687566511528,0
"['010', '000', '101101', '00000', '01010', '11']",24,9,15,0.375,0.625,2,5,0.954434002924965,0
"['1100', '11', '11', '010011', '1', '100100', '111', '1011011', '0']",32,20,12,0.625,0.375,9,4,0.954434002924965,0
"['0110101', '0110001', '00011', '1101', '0', '1', '0101', '11000', '0001', '010']",41,19,22,0.4634146341463415,0.5365853658536586,5,5,0.9961344835095796,0
"['001010', '1001111', '0011', '01111', '111', '10001', '0', '10', '00101']",38,21,17,0.5526315789473685,0.4473684210526316,7,5,0.9919924034538556,0
"['1', '000', '000100', '1', '0000000', '1']",19,4,15,0.2105263157894736,0.7894736842105263,0,7,0.7424875695421236,0
"['0100011', '0', '11110', '0001', '1011111']",24,14,10,0.5833333333333334,0.4166666666666667,6,3,0.9798687566511528,1
"['0010', '011010', '0']",11,4,7,0.3636363636363636,0.6363636363636364,1,3,0.94566030460064,1
"['0', '010010', '1010', '011000', '01', '11']",21,9,12,0.4285714285714285,0.5714285714285714,2,5,0.9852281360342516,0
"['11010', '1']",6,4,2,0.6666666666666666,0.3333333333333333,1,0,0.9182958340544896,1
['11'],2,2,0,1.0,0.0,1,0,-0.0,1
['101111'],6,5,1,0.8333333333333334,0.1666666666666666,2,0,0.6500224216483541,1
"['111', '0011101', '0', '0010', '0011111', '11', '0']",25,15,10,0.6,0.4,5,3,0.9709505944546686,0
['1'],1,1,0,1.0,0.0,0,0,-0.0,1
"['1101', '00', '0100001', '110100', '001', '111', '00100']",30,13,17,0.4333333333333333,0.5666666666666667,4,7,0.9871377743721864,0
"['1', '0111', '10', '0011', '0', '10']",14,8,6,0.5714285714285714,0.4285714285714285,3,1,0.9852281360342516,0
"['10010', '11', '110101', '1011010']",20,12,8,0.6,0.4,4,1,0.9709505944546686,1
"['00100', '110010', '0', '1', '0100', '10110', '000010']",28,10,18,0.3571428571428571,0.6428571428571429,2,7,0.9402859586706313,0
"['11010', '110100', '001', '1000', '11', '001', '10100']",28,13,15,0.4642857142857143,0.5357142857142857,5,5,0.996316519558962,1
['0111110'],7,5,2,0.7142857142857143,0.2857142857142857,2,0,0.863120568566631,1
"['01000', '10001', '11101', '0001', '00']",21,8,13,0.3809523809523809,0.6190476190476191,2,4,0.9587118829771318,0
"['1110111', '00', '011', '100010', '001100', '00', '000101', '110111', '10111', '0010101']",50,26,24,0.52,0.48,8,7,0.9988455359952018,1
"['11', '00', '010', '11101', '00011', '00001', '0', '1011', '0010', '1110111']",38,20,18,0.5263157894736842,0.4736842105263157,6,5,0.9980008838722996,0
"['0111001', '0001', '000010', '0', '0111100', '1', '011010']",32,14,18,0.4375,0.5625,4,6,0.9886994082884974,0
"['1000010', '10100', '1000110', '0', '0', '001000', '01', '1111', '1', '101']",37,16,21,0.4324324324324324,0.5675675675675675,4,8,0.9867867202680318,0
"['001', '010111', '1100', '10001', '110', '00001']",26,12,14,0.4615384615384615,0.5384615384615384,3,5,0.9957274520849256,1
"['110100', '101001']",12,6,6,0.5,0.5,1,2,1.0,1
['010'],3,1,2,0.3333333333333333,0.6666666666666666,0,0,0.9182958340544896,1
['111100'],6,4,2,0.6666666666666666,0.3333333333333333,2,1,0.9182958340544896,1
['01'],2,1,1,0.5,0.5,0,0,1.0,1
['10001'],5,2,3,0.4,0.6,0,1,0.9709505944546686,1
['111100'],6,4,2,0.6666666666666666,0.3333333333333333,2,1,0.9182958340544896,1
"['110101', '101110', '01111', '01', '1100', '111', '01']",28,19,9,0.6785714285714286,0.3214285714285714,7,2,0.9059282160429992,0
"['110110', '001', '1000', '010101', '001101', '1000', '100110', '111']",38,19,19,0.5,0.5,7,6,1.0,1
"['1100', '10']",6,3,3,0.5,0.5,1,1,1.0,1
['1010'],4,2,2,0.5,0.5,0,0,1.0,1
"['01010', '0011', '1011111', '11', '1', '01', '0', '10010', '11110', '100100']",38,22,16,0.5789473684210527,0.4210526315789473,7,4,0.9819407868640976,0
"['001', '0100110', '0000101', '0100111', '1', '11001']",30,14,16,0.4666666666666667,0.5333333333333333,4,6,0.9967916319816366,0
"['0', '110', '0111101', '111', '1111011', '01']",23,17,6,0.7391304347826086,0.2608695652173913,8,1,0.828055725379504,0
"['011', '00101', '101', '0011', '101', '1110101', '10000', '10', '0']",33,17,16,0.5151515151515151,0.4848484848484848,6,5,0.9993375041688848,0
['111101'],6,5,1,0.8333333333333334,0.1666666666666666,2,0,0.6500224216483541,1
"['10', '1011010', '1110']",13,8,5,0.6153846153846154,0.3846153846153846,2,0,0.961236604722876,1
"['0010', '1', '1101100']",12,6,6,0.5,0.5,2,2,1.0,1
"['1', '010110', '001001', '0', '011100']",20,9,11,0.45,0.55,2,4,0.9927744539878084,0
['0'],1,0,1,0.0,1.0,0,0,-0.0,1
"['1011', '1000100', '00', '10001']",18,7,11,0.3888888888888889,0.6111111111111112,1,4,0.964078764808229,0
"['1001001', '0110', '1111', '100', '111', '111', '1010', '10011', '110110']",39,25,14,0.6410256410256411,0.358974358974359,9,4,0.9418285354475155,0
"['01', '11111', '0001', '01001', '010010']",22,11,11,0.5,0.5,3,3,1.0,1
"['01', '0010', '001', '1', '1111111', '11', '111', '001000']",28,17,11,0.6071428571428571,0.3928571428571428,7,4,0.9666186325481028,0
"['1', '0010']",5,2,3,0.4,0.6,0,1,0.9709505944546686,1
"['01', '0110', '1010101', '01011', '0010', '00', '1010', '0', '0000']",33,13,20,0.3939393939393939,0.6060606060606061,2,5,0.9672947789468944,0
"['11010', '1', '00', '000', '01001', '0100110']",23,9,14,0.391304347826087,0.6086956521739131,2,5,0.9656361333706098,0
"['1111', '1110']",8,7,1,0.875,0.125,3,0,0.5435644431995964,1
['010001'],6,2,4,0.3333333333333333,0.6666666666666666,0,1,0.9182958340544896,1
"['11', '1000', '010011', '10', '1111001', '000']",24,12,12,0.5,0.5,4,5,1.0,1
"['00', '0111001', '1101110', '1111100', '10111']",28,18,10,0.6428571428571429,0.3571428571428571,6,3,0.9402859586706313,1
"['00', '0011', '00111', '111', '111', '00110', '0110', '1000110', '010000']",39,19,20,0.4871794871794871,0.5128205128205128,8,9,0.999525689293649,0
['11111'],5,5,0,1.0,0.0,2,0,-0.0,1
"['10001', '00100', '0', '0000', '10', '1110', '1001010', '0011010', '010110', '011111']",47,21,26,0.4468085106382978,0.5531914893617021,5,9,0.9918207974218424,0
"['01', '100', '110001', '1', '0110100', '11001', '110011', '1100', '10111']",39,22,17,0.5641025641025641,0.4358974358974359,9,6,0.98811083652183,0
"['100', '1011', '1']",8,5,3,0.625,0.375,1,1,0.954434002924965,1
"['010100', '101001', '1', '11', '01010', '000101', '111001', '1111', '01', '101001']",44,24,20,0.5454545454545454,0.4545454545454545,7,6,0.9940302114769564,0
"['011', '0110111', '100']",13,8,5,0.6153846153846154,0.3846153846153846,4,1,0.961236604722876,1
"['0110', '1100010', '0', '0100', '1', '100100']",23,9,14,0.391304347826087,0.6086956521739131,3,5,0.9656361333706098,0
"['0', '01110', '00000', '0110', '100010', '0001100', '10', '0001', '11', '00']",38,13,25,0.3421052631578947,0.6578947368421053,4,11,0.9268190639645772,0
"['0110111', '11', '0101']",13,9,4,0.6923076923076923,0.3076923076923077,3,0,0.8904916402194913,1
"['000111', '11111', '010', '1000000', '000100', '10', '0100010', '000110', '010001']",48,18,30,0.375,0.625,5,12,0.954434002924965,0
"['1', '01', '1101', '00100', '1100001', '0010101']",26,12,14,0.4615384615384615,0.5384615384615384,2,5,0.9957274520849256,0
"['0', '11', '1010', '0', '0100', '010100', '010', '110']",24,10,14,0.4166666666666667,0.5833333333333334,2,3,0.9798687566511528,0
"['11111', '011', '1111010', '0101', '0000100', '00']",28,15,13,0.5357142857142857,0.4642857142857143,5,5,0.996316519558962,1
"['1', '0011110', '1010', '00', '01', '0', '0000100', '001001', '1']",31,12,19,0.3870967741935484,0.6129032258064516,3,8,0.9629004147713268,0
"['1110100', '111', '01', '0101011']",19,12,7,0.631578947368421,0.3684210526315789,3,1,0.9494520153879484,1
"['11111', '11010', '110']",13,10,3,0.7692307692307693,0.2307692307692307,4,0,0.7793498372920851,1
"['10101', '1']",6,4,2,0.6666666666666666,0.3333333333333333,1,0,0.9182958340544896,1
"['001011', '11110', '1101', '11111', '100001', '0100101', '011101', '01001']",44,26,18,0.5909090909090909,0.4090909090909091,8,5,0.9760206482366148,0
"['101000', '01', '110', '1101', '00']",17,8,9,0.4705882352941176,0.5294117647058824,2,3,0.9975025463691152,1
"['1', '01', '111010', '00111', '10', '000101']",22,12,10,0.5454545454545454,0.4545454545454545,4,3,0.9940302114769564,0
"['101', '01000']",8,3,5,0.375,0.625,0,1,0.954434002924965,1
"['1', '01111', '001', '11101', '1110', '00', '001110', '0']",27,16,11,0.5925925925925926,0.4074074074074074,7,4,0.975119064940866,0
"['101101', '1']",7,5,2,0.7142857142857143,0.2857142857142857,2,0,0.863120568566631,1
['111010'],6,4,2,0.6666666666666666,0.3333333333333333,1,0,0.9182958340544896,1
['11'],2,2,0,1.0,0.0,1,0,-0.0,1
"['101011', '0', '1111011', '01', '0010111', '00011', '011000']",34,19,15,0.5588235294117647,0.4411764705882353,7,3,0.9899927915575186,0
"['1110010', '10010', '11', '0110', '001', '0100101', '1101111', '110']",38,22,16,0.5789473684210527,0.4210526315789473,7,4,0.9819407868640976,0
"['101000', '11', '0100111', '0', '00']",18,8,10,0.4444444444444444,0.5555555555555556,2,3,0.9910760598382222,0
"['1011100', '0010', '0011101', '11110', '00', '1101']",29,16,13,0.5517241379310345,0.4482758620689655,5,4,0.9922666387194964,1
"['11001', '0011', '1', '01', '101101', '1', '000111', '0', '1111']",30,19,11,0.6333333333333333,0.3666666666666666,8,3,0.9480782435939056,0
"['00', '1', '101001', '0010101']",16,7,9,0.4375,0.5625,1,3,0.9886994082884974,1
"['1001', '101', '00', '10111', '100010', '0', '1', '1', '011011']",29,16,13,0.5517241379310345,0.4482758620689655,6,4,0.9922666387194964,0
"['1011', '11', '010', '011101', '000011']",21,12,9,0.5714285714285714,0.4285714285714285,4,3,0.9852281360342516,1
"['111', '00011', '0']",9,5,4,0.5555555555555556,0.4444444444444444,2,1,0.9910760598382222,1
"['00000', '1101001', '11101', '111', '01']",22,12,10,0.5454545454545454,0.4545454545454545,5,3,0.9940302114769564,0
"['0101001', '11010', '00', '010', '11', '10']",21,10,11,0.4761904761904761,0.5238095238095238,2,3,0.998363672593813,0
"['01010', '10110']",10,5,5,0.5,0.5,1,0,1.0,1
"['001001', '1', '1101001', '0', '1011101', '0001', '11', '0111', '10000']",37,19,18,0.5135135135135135,0.4864864864864865,6,6,0.9994730201859836,0
"['1010100', '00000', '011']",15,5,10,0.3333333333333333,0.6666666666666666,1,4,0.9182958340544896,1
"['1', '1001', '1110']",9,6,3,0.6666666666666666,0.3333333333333333,3,1,0.9182958340544896,1
"['100000', '1111011']",13,7,6,0.5384615384615384,0.4615384615384615,3,2,0.9957274520849256,1
"['1010', '0010', '0010', '0', '1110010', '100', '101000', '100011']",35,14,21,0.4,0.6,2,7,0.9709505944546686,0
"['01010', '1011101', '011000', '00100', '0011001']",30,13,17,0.4333333333333333,0.5666666666666667,3,5,0.9871377743721864,1
"['101011', '00', '1111110', '1101000', '1', '0', '01101', '00', '00111']",36,20,16,0.5555555555555556,0.4444444444444444,7,5,0.9910760598382222,0
"['1', '0110', '1010', '1000', '000', '010001', '00010', '1011']",31,12,19,0.3870967741935484,0.6129032258064516,2,5,0.9629004147713268,0
"['1110001', '101110', '010', '11010', '010111']",27,16,11,0.5925925925925926,0.4074074074074074,5,3,0.975119064940866,1
['0'],1,0,1,0.0,1.0,0,0,-0.0,1
"['10', '1011110', '0']",10,6,4,0.6,0.4,2,1,0.9709505944546686,1
"['000', '01', '0']",6,1,5,0.1666666666666666,0.8333333333333334,0,2,0.6500224216483541,0
"['1111001', '0', '0010100', '0', '010', '1010101', '011', '0001', '010100', '1011']",43,20,23,0.4651162790697674,0.5348837209302325,4,6,0.996485989886783,0
['1110000'],7,3,4,0.4285714285714285,0.5714285714285714,1,2,0.9852281360342516,1
"['0000', '11']",6,2,4,0.3333333333333333,0.6666666666666666,1,2,0.9182958340544896,1
"['1011110', '0000', '10']",13,6,7,0.4615384615384615,0.5384615384615384,2,2,0.9957274520849256,1
"['0', '000', '10', '101', '01010']",14,5,9,0.3571428571428571,0.6428571428571429,0,2,0.9402859586706313,0
"['0000', '111101', '1', '010', '0100', '1', '10100']",24,11,13,0.4583333333333333,0.5416666666666666,4,5,0.99498482818597,0
"['01100', '1101']",9,5,4,0.5555555555555556,0.4444444444444444,2,1,0.9910760598382222,1
"['001111', '001', '1010', '001', '1000']",20,9,11,0.45,0.55,4,4,0.9927744539878084,1
"['1', '0010', '1100111', '101', '11010', '111011', '11000', '10001', '00']",38,21,17,0.5526315789473685,0.4473684210526316,7,5,0.9919924034538556,0
"['100010', '1010101', '01111', '0100101', '111111', '0000001', '01000', '01100']",48,23,25,0.4791666666666667,0.5208333333333334,6,8,0.9987472979361685,1
"['11', '10', '100111', '1', '01', '10', '0', '010', '0000010', '0100010']",33,14,19,0.4242424242424242,0.5757575757575758,4,7,0.9833761901392236,0
"['00', '0', '1', '11100', '001010', '00000', '1', '0101', '0']",26,9,17,0.3461538461538461,0.6538461538461539,2,6,0.9305861291319928,0
"['011100', '000000', '100101', '001111']",24,10,14,0.4166666666666667,0.5833333333333334,3,6,0.9798687566511528,1
"['10', '0011110', '10101', '1110', '0', '00001', '1000001', '1110', '10101', '0110']",44,22,22,0.5,0.5,8,6,1.0,0
"['1010000', '0011100', '0', '0011101', '0']",23,9,14,0.391304347826087,0.6086956521739131,2,5,0.9656361333706098,1
"['111001', '00', '0', '01111', '101']",17,10,7,0.5882352941176471,0.4117647058823529,3,3,0.9774178175281716,0
"['00111', '0', '1', '0011', '10001']",16,8,8,0.5,0.5,2,3,1.0,0
['110'],3,2,1,0.6666666666666666,0.3333333333333333,1,0,0.9182958340544896,1
"['10110', '01', '110101', '000100', '01', '1', '11', '11', '1']",27,16,11,0.5925925925925926,0.4074074074074074,5,3,0.975119064940866,0
"['010', '1101011', '1101', '0', '0', '1101', '001100']",26,14,12,0.5384615384615384,0.4615384615384615,5,3,0.9957274520849256,0
"['11', '0011110', '1010010', '110100', '01000', '001000']",33,14,19,0.4242424242424242,0.5757575757575758,4,6,0.9833761901392236,0
"['110', '100111', '0001', '0001001', '1111001', '10000', '1']",33,16,17,0.4848484848484848,0.5151515151515151,5,7,0.9993375041688848,0
"['11100', '10', '1100', '00100', '0110', '0', '1110', '0100100', '1011']",36,17,19,0.4722222222222222,0.5277777777777778,5,8,0.997772472089982,0
"['1110001', '1001101', '1111', '111011', '1111', '1000', '10', '00', '10', '11']",40,26,14,0.65,0.35,11,4,0.934068055375491,0
"['10', '010', '1101', '010', '010']",15,7,8,0.4666666666666667,0.5333333333333333,1,2,0.9967916319816366,1
"['1000100', '1010011']",14,6,8,0.4285714285714285,0.5714285714285714,1,3,0.9852281360342516,1
"['000101', '0', '01']",9,3,6,0.3333333333333333,0.6666666666666666,0,2,0.9182958340544896,0
"['10', '0']",3,1,2,0.3333333333333333,0.6666666666666666,0,1,0.9182958340544896,1
"['0111', '10', '1', '001']",10,6,4,0.6,0.4,2,1,0.9709505944546686,0
"['00', '11110', '00100', '1010', '1011111', '0010100', '0101101', '0', '100']",41,20,21,0.4878048780487805,0.5121951219512195,5,6,0.9995708393473224,0
"['0000010', '0101', '10', '0111']",17,7,10,0.4117647058823529,0.5882352941176471,2,4,0.9774178175281716,1
"['110110', '1011', '1000']",14,8,6,0.5714285714285714,0.4285714285714285,3,1,0.9852281360342516,1
"['1', '1110']",5,4,1,0.8,0.2,2,0,0.7219280948873623,1
"['11', '01110', '0100']",11,6,5,0.5454545454545454,0.4545454545454545,2,2,0.9940302114769564,1
"['010010', '001', '100001', '11', '0010110', '1111000']",31,14,17,0.4516129032258064,0.5483870967741935,5,6,0.9932338197397066,1
"['11000', '10111', '111010', '111000', '1101101', '0010100']",36,20,16,0.5555555555555556,0.4444444444444444,7,4,0.9910760598382222,1
"['1', '1110000', '11000', '1', '00', '10', '110101', '01', '00110', '100110']",37,18,19,0.4864864864864865,0.5135135135135135,6,6,0.9994730201859836,0
"['1100', '1', '00000', '101']",13,5,8,0.3846153846153846,0.6153846153846154,1,3,0.961236604722876,1
"['1', '0', '111000', '0', '011011', '1110100', '0010', '0']",27,13,14,0.4814814814814814,0.5185185185185185,4,5,0.9990102708804812,0
"['010101', '00000', '01101', '00001', '10', '0000110', '1', '01000', '110111', '11010']",47,20,27,0.425531914893617,0.574468085106383,6,8,0.9839393951635756,0
"['10', '101100']",8,4,4,0.5,0.5,1,1,1.0,1
"['1', '0', '001', '10111', '1110', '1', '1']",16,11,5,0.6875,0.3125,5,1,0.8960382325345574,0
"['01010', '0', '010', '01', '000000', '11']",19,6,13,0.3157894736842105,0.6842105263157895,1,5,0.8997437586982626,0
"['110', '10111', '101']",11,8,3,0.7272727272727273,0.2727272727272727,3,0,0.8453509366224364,1
"['0100', '110', '00111']",12,6,6,0.5,0.5,2,2,1.0,1
['100001'],6,2,4,0.3333333333333333,0.6666666666666666,0,2,0.9182958340544896,1
"['1110', '1', '1100000', '010', '01111', '01']",22,12,10,0.5454545454545454,0.4545454545454545,4,4,0.9940302114769564,0
"['101', '11101', '111111', '1', '0', '11', '0101', '01', '010101']",30,21,9,0.7,0.3,7,0,0.8812908992306927,0
"['01', '1011101', '1', '0001', '01111', '1010', '0100', '0000', '111', '1110']",38,21,17,0.5526315789473685,0.4473684210526316,8,5,0.9919924034538556,0
"['010101', '011000', '001010', '1001', '0', '101', '1010', '00111', '10']",37,17,20,0.4594594594594595,0.5405405405405406,4,4,0.9952525494396792,0
"['01', '1111100', '0101']",13,8,5,0.6153846153846154,0.3846153846153846,3,1,0.961236604722876,0
"['010', '0', '00', '011111', '11110']",17,10,7,0.5882352941176471,0.4117647058823529,4,2,0.9774178175281716,0
"['001', '0011', '010', '110111', '00000', '01000']",26,10,16,0.3846153846153846,0.6153846153846154,3,6,0.961236604722876,1
"['1010', '10', '0010', '0', '11', '11111', '001', '0011', '111011', '10111']",36,23,13,0.6388888888888888,0.3611111111111111,7,4,0.943601631299382,0
"['11', '1011', '1']",7,6,1,0.8571428571428571,0.1428571428571428,2,0,0.5916727785823275,0
"['1011', '11', '001', '11110', '01011', '01010', '10']",26,16,10,0.6153846153846154,0.3846153846153846,5,2,0.961236604722876,0
['0110'],4,2,2,0.5,0.5,1,0,1.0,1
"['1110000', '10110', '001', '1', '0110', '01', '0', '10100']",28,13,15,0.4642857142857143,0.5357142857142857,4,5,0.996316519558962,0
"['1', '110', '1011', '01001', '111', '111001']",22,15,7,0.6818181818181818,0.3181818181818182,5,2,0.9023932827949788,0
"['0001010', '1000', '0111111', '01011', '111', '0', '1', '1010010', '01010']",40,21,19,0.525,0.475,6,5,0.99819587904281,0
"['0111110', '00', '0', '1', '101001', '00000', '11', '111110', '1001', '1']",35,19,16,0.5428571428571428,0.4571428571428571,7,6,0.9946937953613058,0
"['001000', '10', '10', '10110', '1', '1011', '011', '1']",24,13,11,0.5416666666666666,0.4583333333333333,4,2,0.99498482818597,0
"['10', '10100', '1111001', '10101', '010', '1', '0']",24,13,11,0.5416666666666666,0.4583333333333333,3,2,0.99498482818597,0
['0100110'],7,3,4,0.4285714285714285,0.5714285714285714,1,1,0.9852281360342516,1
"['00', '0000000', '1011', '1001111', '11']",22,10,12,0.4545454545454545,0.5454545454545454,4,5,0.9940302114769564,0
"['10', '0001', '01101', '101010', '11010', '1010', '11001']",31,16,15,0.5161290322580645,0.4838709677419355,4,3,0.9992492479956564,0
"['00', '0011101', '110110', '11110', '011', '0010', '01001', '1', '1000010', '11000']",45,22,23,0.4888888888888889,0.5111111111111111,8,9,0.999643749677856,0
"['101', '10000', '010000', '0', '0001', '011100', '0100011', '001100']",38,13,25,0.3421052631578947,0.6578947368421053,4,10,0.9268190639645772,0
"['1', '100']",4,2,2,0.5,0.5,1,1,1.0,1
"['0001101', '01110', '111010', '001']",21,11,10,0.5238095238095238,0.4761904761904761,3,2,0.998363672593813,1
"['1', '00011', '010000', '1', '1', '00011', '01', '1001', '000000', '10010']",36,13,23,0.3611111111111111,0.6388888888888888,4,9,0.943601631299382,0
"['101000', '11', '11', '111011', '100001']",22,13,9,0.5909090909090909,0.4090909090909091,4,3,0.9760206482366148,1
"['001', '10', '00010']",10,3,7,0.3,0.7,1,3,0.8812908992306927,1
['1'],1,1,0,1.0,0.0,0,0,-0.0,1
"['10', '101000', '01', '110100', '01110']",21,10,11,0.4761904761904761,0.5238095238095238,2,3,0.998363672593813,1
"['111', '010', '0000100', '010']",16,6,10,0.375,0.625,1,3,0.954434002924965,1
"['0111', '1', '101000', '1011', '0101', '00100', '1', '11', '00000']",32,15,17,0.46875,0.53125,4,5,0.9971803988942642,0
"['00', '110011', '0011100', '000111', '1110000', '1110011', '100001', '101', '0111']",48,25,23,0.5208333333333334,0.4791666666666667,10,10,0.9987472979361685,0
"['1', '1100110', '00', '100111', '10']",18,10,8,0.5555555555555556,0.4444444444444444,4,3,0.9910760598382222,0
"['10', '100111', '1001', '011000', '00', '1000']",24,10,14,0.4166666666666667,0.5833333333333334,3,5,0.9798687566511528,0
"['1', '011']",4,3,1,0.75,0.25,1,0,0.8112781244591328,1
"['0011', '000000', '01011', '1', '01']",18,7,11,0.3888888888888889,0.6111111111111112,2,4,0.964078764808229,0
"['1001', '1', '1100', '1', '0100101', '01', '00000']",24,10,14,0.4166666666666667,0.5833333333333334,2,5,0.9798687566511528,0
"['10011', '01', '0001010', '01', '0110']",20,9,11,0.45,0.55,2,3,0.9927744539878084,1
"['0111', '0', '10', '1110110', '0', '101000', '00001']",26,12,14,0.4615384615384615,0.5384615384615384,3,4,0.9957274520849256,0
"['1001', '11', '1']",7,5,2,0.7142857142857143,0.2857142857142857,2,1,0.863120568566631,0
"['1000', '1100', '11100', '0', '1000', '0', '00', '00']",23,7,16,0.3043478260869565,0.6956521739130435,2,7,0.8865408928220899,0
['001'],3,1,2,0.3333333333333333,0.6666666666666666,0,1,0.9182958340544896,1
['011'],3,2,1,0.6666666666666666,0.3333333333333333,1,0,0.9182958340544896,1
"['111111', '10', '000', '10', '00010', '001011']",24,12,12,0.5,0.5,4,5,1.0,0
"['000', '01100', '01010', '0']",14,4,10,0.2857142857142857,0.7142857142857143,1,4,0.863120568566631,0
['0'],1,0,1,0.0,1.0,0,0,-0.0,1
"['010', '000', '10', '11']",10,4,6,0.4,0.6,1,2,0.9709505944546686,1
"['10', '001', '00011', '0010', '100', '001001']",23,8,15,0.3478260869565217,0.6521739130434783,1,6,0.9321115676166748,0
"['010011', '11', '001', '110010']",17,9,8,0.5294117647058824,0.4705882352941176,3,3,0.9975025463691152,1
"['1101010', '0101011', '00', '11', '00101', '10', '101', '0011', '001111']",38,21,17,0.5526315789473685,0.4473684210526316,7,5,0.9919924034538556,0
['0'],1,0,1,0.0,1.0,0,0,-0.0,1
"['0', '10', '111101', '000']",12,6,6,0.5,0.5,2,1,1.0,0
"['000110', '000', '0010', '10', '10011', '000001', '00001']",31,9,22,0.2903225806451613,0.7096774193548387,2,9,0.869137580612638,0
"['1100010', '0', '0100', '11000', '101']",20,8,12,0.4,0.6,2,4,0.9709505944546686,0
"['000', '1100101', '0110000', '0', '101', '0100100', '110', '00010', '1110010']",43,17,26,0.3953488372093023,0.6046511627906976,4,9,0.9681647320759544,0
"['10111', '100', '001', '00', '110010']",19,9,10,0.4736842105263157,0.5263157894736842,3,4,0.9980008838722996,0
"['0', '0001', '1', '00100', '0011001', '000', '0101', '0011', '1111', '1111']",37,18,19,0.4864864864864865,0.5135135135135135,7,9,0.9994730201859836,0
"['10110', '0111', '100', '0111101', '11110', '011', '100111', '1']",34,23,11,0.6764705882352942,0.3235294117647059,10,4,0.9081783472997051,0
"['100100', '0', '0001011', '011110', '110']",23,11,12,0.4782608695652174,0.5217391304347826,4,4,0.9986359641585718,1
"['010111', '01', '101010', '1111011', '001']",24,15,9,0.625,0.375,5,1,0.954434002924965,1
"['1001', '100010', '0', '0010111', '00010', '1110010', '1110010', '00', '0011100', '1']",47,21,26,0.4468085106382978,0.5531914893617021,5,10,0.9918207974218424,0
"['1', '000', '00011', '1000', '000111']",19,7,12,0.3684210526315789,0.631578947368421,2,6,0.9494520153879484,0
"['0100110', '0111', '0', '01', '111001', '100100', '01']",28,14,14,0.5,0.5,5,6,1.0,0
"['0001', '0111111', '10', '0111101', '0', '001', '100000', '0111001']",37,19,18,0.5135135135135135,0.4864864864864865,7,7,0.9994730201859836,0
"['10', '01', '10111', '1', '00010', '001000', '1110001', '10']",30,14,16,0.4666666666666667,0.5333333333333333,5,5,0.9967916319816366,0
"['10', '0', '1', '1101', '000', '001']",14,6,8,0.4285714285714285,0.5714285714285714,1,3,0.9852281360342516,0
"['10', '00100', '1', '01100', '110111', '0111', '001110', '0010', '001010', '100001']",45,21,24,0.4666666666666667,0.5333333333333333,5,8,0.9967916319816366,0
"['000001', '0001001', '000111', '0001', '0110', '11101', '100110', '11011', '010110', '010010']",55,25,30,0.4545454545454545,0.5454545454545454,8,9,0.9940302114769564,1
"['100', '01', '0010', '01110', '0110', '110', '110', '1010010', '001010', '000101']",43,19,24,0.4418604651162791,0.5581395348837209,4,8,0.9902246902198684,0
"['0010110', '100000', '011001', '01', '010101', '00', '11110', '110', '1101']",41,20,21,0.4878048780487805,0.5121951219512195,6,6,0.9995708393473224,0
"['00', '0111110', '000', '10101']",17,8,9,0.4705882352941176,0.5294117647058824,2,3,0.9975025463691152,0
['0001'],4,1,3,0.25,0.75,0,1,0.8112781244591328,1
"['0100', '0001111', '11', '0100000', '1001', '1', '1101110', '01']",34,17,17,0.5,0.5,6,6,1.0,0
"['0001', '100', '1100', '011011', '000', '10', '1101000', '101011']",35,16,19,0.4571428571428571,0.5428571428571428,6,5,0.9946937953613058,0
"['1100001', '1011', '000100', '101', '0011001']",27,12,15,0.4444444444444444,0.5555555555555556,4,6,0.9910760598382222,1
"['1010111', '10010', '11']",14,9,5,0.6428571428571429,0.3571428571428571,3,1,0.9402859586706313,1
"['00', '110', '111', '111', '011100', '1001', '1', '0101111', '100000']",35,20,15,0.5714285714285714,0.4285714285714285,8,5,0.9852281360342516,0
"['0110001', '01110', '1', '11', '11', '0', '01100', '0010', '1111', '0']",32,18,14,0.5625,0.4375,7,4,0.9886994082884974,0
"['0110', '0111000', '0000', '10111', '10100', '111001']",31,15,16,0.4838709677419355,0.5161290322580645,5,6,0.9992492479956564,1
['00'],2,0,2,0.0,1.0,0,1,-0.0,1
"['10111', '010', '1001', '01', '0100100', '1', '0101001', '1010101']",36,18,18,0.5,0.5,2,4,1.0,0
['101010'],6,3,3,0.5,0.5,0,0,1.0,1
"['0000001', '01', '111000', '100011', '010011', '00110', '11110', '110', '000']",43,19,24,0.4418604651162791,0.5581395348837209,8,9,0.9902246902198684,0
"['0', '001101', '111', '101', '11']",15,10,5,0.6666666666666666,0.3333333333333333,4,1,0.9182958340544896,0
"['011111', '10011', '1', '011110', '00', '0000', '01000', '1111']",33,18,15,0.5454545454545454,0.4545454545454545,8,6,0.9940302114769564,0
"['00', '01011', '000001', '11100', '101001', '110011', '1110', '01', '110']",39,20,19,0.5128205128205128,0.4871794871794871,7,7,0.999525689293649,0
"['0000100', '11101', '0', '11', '001010', '00100', '0', '1000', '0111']",35,14,21,0.4,0.6,3,8,0.9709505944546686,0
"['0001', '011101']",10,5,5,0.5,0.5,1,1,1.0,1
"['01', '10011', '110110', '100111', '11', '10']",23,15,8,0.6521739130434783,0.3478260869565217,7,2,0.9321115676166748,0
"['1111110', '00111', '1', '00', '0110111', '110010']",28,18,10,0.6428571428571429,0.3571428571428571,8,3,0.9402859586706313,0
"['01100', '10', '01']",9,4,5,0.4444444444444444,0.5555555555555556,1,2,0.9910760598382222,1
"['1111010', '110111', '0010', '001', '1101101', '101000']",33,19,14,0.5757575757575758,0.4242424242424242,7,3,0.9833761901392236,1
['1'],1,1,0,1.0,0.0,0,0,-0.0,1
"['00', '1110101', '0', '10', '00', '00111', '110100', '010100', '00', '01']",35,15,20,0.4285714285714285,0.5714285714285714,3,6,0.9852281360342516,0
['1'],1,1,0,1.0,0.0,0,0,-0.0,1
"['100110', '111100', '11100', '0010', '1001010']",28,14,14,0.5,0.5,4,5,1.0,1
"['010110', '1010', '10', '110', '10', '1110010', '00010', '01100']",34,16,18,0.4705882352941176,0.5294117647058824,4,5,0.9975025463691152,0
"['101100', '00', '110110', '0', '1111', '111101', '0']",26,16,10,0.6153846153846154,0.3846153846153846,7,3,0.961236604722876,0
"['11', '0011', '01', '0', '101100', '1', '0', '00010', '01']",24,11,13,0.4583333333333333,0.5416666666666666,3,5,0.99498482818597,0
"['11', '10', '10']",6,4,2,0.6666666666666666,0.3333333333333333,1,0,0.9182958340544896,1
"['0110', '100011', '101', '011100', '100']",22,11,11,0.5,0.5,3,3,1.0,0
"['10', '00', '000', '0', '11001']",13,4,9,0.3076923076923077,0.6923076923076923,1,4,0.8904916402194913,0
"['0101110', '0', '01', '110', '100', '11', '0', '001', '101']",25,13,12,0.52,0.48,4,3,0.9988455359952018,0
['1001'],4,2,2,0.5,0.5,0,1,1.0,1
"['100', '1010', '1101']",11,6,5,0.5454545454545454,0.4545454545454545,1,1,0.9940302114769564,1
"['110001', '0', '11', '1000100']",16,7,9,0.4375,0.5625,2,3,0.9886994082884974,0
"['1011000', '01111']",12,7,5,0.5833333333333334,0.4166666666666667,3,2,0.9798687566511528,1
"['1001', '01101', '1', '0001000', '11100', '1000001', '0100', '000']",36,13,23,0.3611111111111111,0.6388888888888888,3,8,0.943601631299382,0
['1101'],4,3,1,0.75,0.25,1,0,0.8112781244591328,1
"['10', '111001', '11100', '110']",16,10,6,0.625,0.375,4,2,0.954434002924965,0
"['100010', '001', '101', '1100', '1010001']",23,10,13,0.4347826086956521,0.5652173913043478,2,4,0.9876925088958034,1
"['0101101', '1011']",11,7,4,0.6363636363636364,0.3636363636363636,3,0,0.94566030460064,1
"['01', '1111011', '110000', '1001', '0', '011', '000', '0010011', '0', '1110010']",41,20,21,0.4878048780487805,0.5121951219512195,7,8,0.9995708393473224,0
"['00010', '101000', '0']",12,3,9,0.25,0.75,0,3,0.8112781244591328,1
"['0001111', '1011', '0', '1010', '000100']",22,10,12,0.4545454545454545,0.5454545454545454,3,4,0.9940302114769564,1
"['1', '11', '101011', '1110', '111', '0', '0101010', '1', '0']",26,17,9,0.6538461538461539,0.3461538461538461,5,1,0.9305861291319928,0
['101001'],6,3,3,0.5,0.5,0,1,1.0,1
"['01', '00', '000101']",10,3,7,0.3,0.7,0,2,0.8812908992306927,0
"['0101', '001', '1']",8,4,4,0.5,0.5,1,1,1.0,1
"['100110', '0110', '11100', '100', '1111101', '011', '0', '11', '01', '0111']",37,23,14,0.6216216216216216,0.3783783783783784,8,4,0.9568886656798212,0
"['1010110', '11110', '00010', '10', '00010', '01000']",29,12,17,0.4137931034482758,0.5862068965517241,3,6,0.9784493292686188,1
['101'],3,2,1,0.6666666666666666,0.3333333333333333,0,0,0.9182958340544896,1
"['1', '00011', '001100', '11', '0', '1', '0']",17,8,9,0.4705882352941176,0.5294117647058824,3,3,0.9975025463691152,0
"['0001010', '1', '0101011', '0']",16,7,9,0.4375,0.5625,1,1,0.9886994082884974,0
"['00', '001']",5,1,4,0.2,0.8,0,2,0.7219280948873623,1
"['110', '00', '1111', '0111011', '10', '0111', '001', '10100', '111', '000']",36,21,15,0.5833333333333334,0.4166666666666667,8,5,0.9798687566511528,0
"['1110110', '0', '0011', '0010111', '00', '010']",24,12,12,0.5,0.5,4,4,1.0,0
"['0110011', '0101101', '101', '1111101', '001']",27,17,10,0.6296296296296297,0.3703703703703703,7,2,0.9509560484549724,1
"['100', '1110000', '10', '0001', '0', '1001', '10', '10111', '010']",31,14,17,0.4516129032258064,0.5483870967741935,3,6,0.9932338197397066,0
"['10', '1']",3,2,1,0.6666666666666666,0.3333333333333333,0,0,0.9182958340544896,1
"['01101', '000111', '0', '010']",15,7,8,0.4666666666666667,0.5333333333333333,2,2,0.9967916319816366,1
"['011000', '1101', '1111']",14,9,5,0.6428571428571429,0.3571428571428571,4,1,0.9402859586706313,1
"['0', '0', '00110', '0111100', '110001', '001000', '100', '1000', '011010']",39,15,24,0.3846153846153846,0.6153846153846154,5,10,0.961236604722876,0
"['110', '0', '100110', '1111', '10', '1', '1101', '11110']",26,18,8,0.6923076923076923,0.3076923076923077,7,2,0.8904916402194913,0
"['100100', '0110', '1', '011']",14,7,7,0.5,0.5,2,2,1.0,0
"['1110', '1011', '001', '1', '10', '0', '1100101']",22,13,9,0.5909090909090909,0.4090909090909091,4,3,0.9760206482366148,0
"['011', '010001', '0100001']",16,6,10,0.375,0.625,1,3,0.954434002924965,1
"['1010', '1011011', '0101', '10101', '111', '011']",26,17,9,0.6538461538461539,0.3461538461538461,6,0,0.9305861291319928,0
"['000100', '10', '1001110', '01', '10010', '010', '011011']",31,14,17,0.4516129032258064,0.5483870967741935,4,7,0.9932338197397066,0
"['1100', '0001011', '0011011', '1101111', '1101', '1', '0101000', '10001', '001', '000']",48,24,24,0.5,0.5,9,7,1.0,0
"['11000', '0101110', '010', '1010001', '00101']",27,12,15,0.4444444444444444,0.5555555555555556,2,5,0.9910760598382222,1
"['10', '0001', '1110', '00']",12,5,7,0.4166666666666667,0.5833333333333334,2,3,0.9798687566511528,1
"['1010', '0101001', '00011', '10110', '0', '01', '1', '111111', '110000']",37,20,17,0.5405405405405406,0.4594594594594595,7,6,0.9952525494396792,0
"['11010', '100', '0010111', '0']",16,8,8,0.5,0.5,2,2,1.0,1
"['1111001', '0101010', '0111111', '0100', '00', '10', '001', '0001101']",39,20,19,0.5128205128205128,0.4871794871794871,6,6,0.999525689293649,0
"['0101101', '0', '110', '1001', '111', '01', '0010100']",27,14,13,0.5185185185185185,0.4814814814814814,4,3,0.9990102708804812,0
"['110011', '0', '101111', '101', '00101', '001', '0010', '11']",30,17,13,0.5666666666666667,0.4333333333333333,5,4,0.9871377743721864,0
"['00110', '11', '00011', '001', '0', '111010', '1000', '0', '10010', '0']",33,14,19,0.4242424242424242,0.5757575757575758,4,7,0.9833761901392236,0
"['11', '1101', '1000011', '0001', '110101', '111', '1', '101110', '0001', '1']",38,23,15,0.6052631578947368,0.3947368421052631,10,5,0.9677884628267678,0
"['010', '1110']",7,4,3,0.5714285714285714,0.4285714285714285,1,0,0.9852281360342516,1
"['11', '0', '110110', '10111', '0111']",18,13,5,0.7222222222222222,0.2777777777777778,5,0,0.8524051786494786,0
"['11', '10', '01', '0110', '1010', '1111100', '1010', '11111', '10']",32,21,11,0.65625,0.34375,7,2,0.9283620723948676,0
"['000101', '000100', '0001', '110', '001', '110110', '100000']",34,12,22,0.3529411764705882,0.6470588235294118,3,7,0.9366673818775626,0
"['011', '01']",5,3,2,0.6,0.4,1,0,0.9709505944546686,1
"['0', '1', '11010', '110']",10,6,4,0.6,0.4,2,0,0.9709505944546686,0
"['11101', '100001', '1', '1000100']",19,9,10,0.4736842105263157,0.5263157894736842,3,4,0.9980008838722996,1
"['1110011', '111', '110110', '011', '111111', '00111', '111111']",36,29,7,0.8055555555555556,0.1944444444444444,13,3,0.710676853856123,0
['110101'],6,4,2,0.6666666666666666,0.3333333333333333,1,0,0.9182958340544896,1
"['1001100', '1111', '011000', '00111', '100', '001', '10111', '0010']",37,19,18,0.5135135135135135,0.4864864864864865,8,7,0.9994730201859836,1
"['10', '1', '1010', '10110', '01100', '110110', '00001', '0']",29,14,15,0.4827586206896552,0.5172413793103449,5,4,0.9991421039919088,0
"['00101', '1', '0010010']",13,5,8,0.3846153846153846,0.6153846153846154,1,3,0.961236604722876,1
"['1', '0', '100', '0101010', '111', '10']",17,9,8,0.5294117647058824,0.4705882352941176,2,1,0.9975025463691152,0
"['1101111', '11100', '00', '00111', '10', '001001', '000000', '01']",35,16,19,0.4571428571428571,0.5428571428571428,6,8,0.9946937953613058,0
"['011000', '1001', '0', '1010001', '00110', '01111', '11']",30,15,15,0.5,0.5,5,5,1.0,0
"['011111', '0001', '0110', '0', '1111011', '01']",24,15,9,0.625,0.375,6,2,0.954434002924965,0
['101'],3,2,1,0.6666666666666666,0.3333333333333333,0,0,0.9182958340544896,1
"['0110', '111', '011', '0111', '001010', '0', '0010110', '0001', '0', '111']",36,19,17,0.5277777777777778,0.4722222222222222,6,5,0.997772472089982,0
"['01', '0111', '0001', '0110010', '001010', '11101', '1', '0111', '1111', '011']",40,24,16,0.6,0.4,8,3,0.9709505944546686,0
"['001000', '110010', '01']",14,5,9,0.3571428571428571,0.6428571428571429,1,4,0.9402859586706313,1
"['001000', '0']",7,1,6,0.1428571428571428,0.8571428571428571,0,3,0.5916727785823275,1
['100111'],6,4,2,0.6666666666666666,0.3333333333333333,1,1,0.9182958340544896,1
"['11001', '000', '0010', '01', '0111', '0001101', '001', '001110']",34,15,19,0.4411764705882353,0.5588235294117647,4,7,0.9899927915575186,0
"['1', '010010', '01', '0101', '111', '11', '01000', '101110', '1110101']",36,21,15,0.5833333333333334,0.4166666666666667,5,3,0.9798687566511528,0
"['11', '1101101', '0', '100', '010', '0100000']",23,10,13,0.4347826086956521,0.5652173913043478,3,4,0.9876925088958034,0
"['001111', '11', '0100111', '00000', '1100', '1100011', '110010', '1', '10']",40,21,19,0.525,0.475,9,7,0.99819587904281,0
"['01110', '001001']",11,5,6,0.4545454545454545,0.5454545454545454,1,2,0.9940302114769564,1
"['1000', '01', '101', '1', '00', '1']",13,6,7,0.4615384615384615,0.5384615384615384,2,3,0.9957274520849256,0
"['1110', '00', '111', '01000', '00', '011110', '00']",24,11,13,0.4583333333333333,0.5416666666666666,4,5,0.99498482818597,1
"['1111', '101111', '110', '111101']",19,16,3,0.8421052631578947,0.1578947368421052,7,0,0.6292492238560345,1
"['0000010', '1000']",11,2,9,0.1818181818181818,0.8181818181818182,0,3,0.6840384356390417,1
"['0000', '00', '0101011', '000001', '001']",22,6,16,0.2727272727272727,0.7272727272727273,1,6,0.8453509366224364,0
"['1000', '011000', '0', '1', '101', '0', '010']",19,7,12,0.3684210526315789,0.631578947368421,2,5,0.9494520153879484,0
"['001', '10']",5,2,3,0.4,0.6,1,1,0.9709505944546686,1
"['001011', '0010', '111', '0']",14,7,7,0.5,0.5,2,2,1.0,1
"['0100001', '110011', '011']",16,8,8,0.5,0.5,3,3,1.0,1
"['011', '000011', '111001', '0101', '1110111', '0100010', '1', '111', '010']",40,23,17,0.575,0.425,8,4,0.983708262623186,0
"['110', '1011', '1']",8,6,2,0.75,0.25,2,0,0.8112781244591328,0
"['101', '10001']",8,4,4,0.5,0.5,1,1,1.0,1
"['0', '11', '0111']",7,5,2,0.7142857142857143,0.2857142857142857,2,0,0.863120568566631,1
"['10000', '0101111', '00001', '101110', '0011']",27,13,14,0.4814814814814814,0.5185185185185185,5,5,0.9990102708804812,1
"['00001', '00']",7,1,6,0.1428571428571428,0.8571428571428571,0,3,0.5916727785823275,1
"['1', '110110', '1', '100']",11,7,4,0.6363636363636364,0.3636363636363636,3,1,0.94566030460064,1
['00'],2,0,2,0.0,1.0,0,1,-0.0,1
"['1010011', '0', '1', '10', '100', '0100', '011010', '00111', '10010', '011100']",40,19,21,0.475,0.525,6,7,0.99819587904281,0
"['1100', '0000', '00', '0010010', '00000', '00101', '100110', '0010011', '1010']",44,14,30,0.3181818181818182,0.6818181818181818,4,13,0.9023932827949788,0
"['0', '011000', '001', '01000', '1110', '1000', '110100', '001001']",35,13,22,0.3714285714285714,0.6285714285714286,3,8,0.9517626756348312,0
"['1110001', '00111']",12,7,5,0.5833333333333334,0.4166666666666667,2,2,0.9798687566511528,1
"['001110', '00100', '100', '001101', '1111', '1010010', '000', '0000110']",41,17,24,0.4146341463414634,0.5853658536585366,6,10,0.9788698505067784,1
"['11', '111101', '00010', '1010', '0100011']",24,13,11,0.5416666666666666,0.4583333333333333,4,3,0.99498482818597,1
['00'],2,0,2,0.0,1.0,0,1,-0.0,1
"['0', '0110111', '01111']",13,9,4,0.6923076923076923,0.3076923076923077,4,1,0.8904916402194913,1
"['0', '00', '01111', '10', '0', '00', '00', '111001', '001011']",27,12,15,0.4444444444444444,0.5555555555555556,4,7,0.9910760598382222,0
"['00', '0100', '001', '11110', '0', '11101', '0', '0', '0111111']",29,16,13,0.5517241379310345,0.4482758620689655,6,5,0.9922666387194964,0
"['010010', '100110', '0', '001', '00', '1110', '1101']",26,12,14,0.4615384615384615,0.5384615384615384,3,5,0.9957274520849256,0
"['0011111', '0', '1111010']",15,10,5,0.6666666666666666,0.3333333333333333,4,1,0.9182958340544896,1
"['1', '11']",3,3,0,1.0,0.0,1,0,-0.0,0
"['00', '100101', '0', '00', '1']",12,4,8,0.3333333333333333,0.6666666666666666,0,3,0.9182958340544896,0
"['1110', '1000', '1', '00', '110', '110110', '0110010', '1110100']",34,18,16,0.5294117647058824,0.4705882352941176,6,5,0.9975025463691152,0
"['000', '1111']",7,4,3,0.5714285714285714,0.4285714285714285,2,1,0.9852281360342516,1
['00111'],5,3,2,0.6,0.4,1,1,0.9709505944546686,1
"['1000', '0001', '101', '101011', '1010011']",24,12,12,0.5,0.5,4,4,1.0,1
"['0', '0101']",5,2,3,0.4,0.6,0,1,0.9709505944546686,1
"['0000', '00', '111']",9,3,6,0.3333333333333333,0.6666666666666666,1,3,0.9182958340544896,0
"['000', '11', '00', '11101']",12,6,6,0.5,0.5,2,2,1.0,0
"['1', '1000', '100101', '1', '0', '101', '0100', '01', '11101']",27,14,13,0.5185185185185185,0.4814814814814814,4,3,0.9990102708804812,0
"['110', '0011011', '1100100', '001000', '001', '10', '00001']",33,13,20,0.3939393939393939,0.6060606060606061,5,8,0.9672947789468944,0
"['00', '0', '1']",4,1,3,0.25,0.75,0,1,0.8112781244591328,0
"['100101', '0', '01001', '111010', '1010', '010', '01001']",30,14,16,0.4666666666666667,0.5333333333333333,2,6,0.9967916319816366,0
"['011111', '111010', '11101', '10111', '1000101', '111']",32,23,9,0.71875,0.28125,10,1,0.8571484374283715,1
"['101', '0010']",7,3,4,0.4285714285714285,0.5714285714285714,0,1,0.9852281360342516,1
"['01110', '101111', '110', '1']",15,11,4,0.7333333333333333,0.2666666666666666,4,0,0.8366407419411672,0
"['001100', '1101111', '0']",14,8,6,0.5714285714285714,0.4285714285714285,4,2,0.9852281360342516,1
"['111', '1101', '0100110', '111', '11', '111', '1110010']",29,21,8,0.7241379310344828,0.2758620689655172,8,2,0.8497511372532974,0
"['0010100', '001101', '101111', '0010110']",26,13,13,0.5,0.5,5,4,1.0,1
"['1111110', '00111', '1001101', '00110', '101111', '010111', '0', '000']",40,24,16,0.6,0.4,10,5,0.9709505944546686,0
"['0', '0']",2,0,2,0.0,1.0,0,1,-0.0,1
"['1100110', '11010', '0000', '1', '01011', '00']",24,11,13,0.4583333333333333,0.5416666666666666,4,4,0.99498482818597,0
"['0110', '11010', '111', '1110', '0011']",20,13,7,0.65,0.35,6,1,0.934068055375491,1
"['1', '1']",2,2,0,1.0,0.0,1,0,-0.0,1
"['111', '00110', '0111110', '0101', '0000101', '111', '11001', '000011', '0010111']",47,26,21,0.5531914893617021,0.4468085106382978,9,9,0.9918207974218424,1
"['1010001', '1', '00111']",13,7,6,0.5384615384615384,0.4615384615384615,2,2,0.9957274520849256,1
"['111', '01001', '1', '010000', '01101', '0011100']",27,13,14,0.4814814814814814,0.5185185185185185,4,5,0.9990102708804812,0
['0110010'],7,3,4,0.4285714285714285,0.5714285714285714,1,1,0.9852281360342516,1
"['11111', '10', '111', '1111', '0011', '1001', '010000', '111']",31,21,10,0.6774193548387096,0.3225806451612903,8,4,0.907165767573082,0
"['1', '1', '0101', '10', '1110100', '11']",17,11,6,0.6470588235294118,0.3529411764705882,4,1,0.9366673818775626,0
"['1100', '0010', '1010110', '01', '01', '0100', '10000']",28,11,17,0.3928571428571428,0.6071428571428571,2,6,0.9666186325481028,1
"['1110', '0100', '100011', '00110', '00', '00010', '001', '1100011', '0']",37,15,22,0.4054054054054054,0.5945945945945946,5,9,0.974024864435752,0
"['01011', '11', '000110', '101101', '01', '1', '010101', '1011101', '0111', '00100']",44,25,19,0.5681818181818182,0.4318181818181818,8,3,0.9865446300055644,0
"['01', '11', '11', '10000', '010', '0100001', '01000', '1001011']",33,14,19,0.4242424242424242,0.5757575757575758,4,7,0.9833761901392236,0
"['010', '0001', '1001000', '1']",15,5,10,0.3333333333333333,0.6666666666666666,1,4,0.9182958340544896,1
"['11', '001001', '000', '1', '011110', '01']",20,10,10,0.5,0.5,3,4,1.0,0
"['001000', '11', '0100010', '11001', '011010', '1', '100100', '0001111', '010', '1111']",47,23,24,0.4893617021276595,0.5106382978723404,8,7,0.9996734260048916,0
"['0100', '1111011', '11110', '10011', '111001', '01', '000011', '10010', '01']",42,24,18,0.5714285714285714,0.4285714285714285,8,7,0.9852281360342516,0
"['0', '001', '00', '1100001', '01', '0']",16,5,11,0.3125,0.6875,1,4,0.8960382325345574,0
"['1', '0000', '101', '010', '110001', '11100', '01010', '110111', '10']",35,18,17,0.5142857142857142,0.4857142857142857,6,4,0.9994110647387552,0
"['01', '100011', '100001', '0101110', '10100']",26,12,14,0.4615384615384615,0.5384615384615384,3,4,0.9957274520849256,1
['01000'],5,1,4,0.2,0.8,0,1,0.7219280948873623,1
"['0110', '10', '0', '1', '010', '00110', '1', '01']",19,9,10,0.4736842105263157,0.5263157894736842,2,2,0.9980008838722996,0
['000'],3,0,3,0.0,1.0,0,1,-0.0,1
"['011', '00', '1110100', '10010', '000', '0000', '0000', '101000', '11010', '110111']",45,18,27,0.4,0.6,5,10,0.9709505944546686,0
"['1011', '0100']",8,4,4,0.5,0.5,1,1,1.0,1
"['0110', '1101111', '0', '00111', '10010', '1']",23,14,9,0.6086956521739131,0.391304347826087,6,2,0.9656361333706098,0
['0100'],4,1,3,0.25,0.75,0,1,0.8112781244591328,1
"['1101', '100000']",10,4,6,0.4,0.6,2,2,0.9709505944546686,1
"['101', '1001100', '0', '00010', '111000', '011', '10000', '1110111', '1010001']",44,21,23,0.4772727272727273,0.5227272727272727,7,9,0.9985090989176322,0
"['0001', '101111', '0100', '001', '10', '0011101', '110100', '1011110', '1001111', '11']",48,28,20,0.5833333333333334,0.4166666666666667,11,6,0.9798687566511528,0
"['1110', '00', '100000', '1100', '0101', '0001010', '01000', '011101', '1', '000']",42,16,26,0.3809523809523809,0.6190476190476191,4,9,0.9587118829771318,0
"['0001', '0', '010111', '11']",13,7,6,0.5384615384615384,0.4615384615384615,2,2,0.9957274520849256,1
"['11', '0', '100', '1', '0000110', '1000']",18,7,11,0.3888888888888889,0.6111111111111112,2,4,0.964078764808229,0
"['01001', '0', '101', '1', '1000', '0101', '1001', '1', '0010011', '0001001']",37,16,21,0.4324324324324324,0.5675675675675675,4,8,0.9867867202680318,0
"['101011', '111101', '11', '0101101', '1', '1001', '01', '011100', '11']",36,24,12,0.6666666666666666,0.3333333333333333,8,2,0.9182958340544896,0
"['01', '01110', '1110', '1001100', '1', '0']",20,11,9,0.55,0.45,3,2,0.9927744539878084,0
"['011010', '0101', '0001100', '101110', '1', '1101']",28,15,13,0.5357142857142857,0.4642857142857143,4,3,0.996316519558962,0
"['1110', '011', '10']",9,6,3,0.6666666666666666,0.3333333333333333,2,1,0.9182958340544896,1
"['0010100', '01', '101', '00110', '110001', '10']",25,11,14,0.44,0.56,4,4,0.9895875212220556,0
"['1111', '01111', '11', '001101', '001001', '1101111', '1000', '0000']",38,22,16,0.5789473684210527,0.4210526315789473,9,6,0.9819407868640976,0
"['1', '101101']",7,5,2,0.7142857142857143,0.2857142857142857,2,0,0.863120568566631,1
"['000100', '11']",8,3,5,0.375,0.625,1,2,0.954434002924965,1
"['110', '1000', '0010', '01000', '001000', '0111100', '00000', '0', '000001', '0111']",45,14,31,0.3111111111111111,0.6888888888888889,4,13,0.8944518845341283,0
"['11', '11000', '11', '01', '001', '00000', '0111', '0110', '0001']",31,14,17,0.4516129032258064,0.5483870967741935,5,7,0.9932338197397066,0
"['1', '1', '000', '011', '0', '00111']",14,7,7,0.5,0.5,3,3,1.0,0
"['0000010', '1', '10011']",13,5,8,0.3846153846153846,0.6153846153846154,2,3,0.961236604722876,1
"['000', '1']",4,1,3,0.25,0.75,0,1,0.8112781244591328,1
"['1010011', '010011', '0010', '1110']",21,11,10,0.5238095238095238,0.4761904761904761,3,3,0.998363672593813,1
"['11100', '0000001', '011', '01', '10110', '1', '00', '0', '10100']",31,13,18,0.4193548387096774,0.5806451612903226,4,6,0.9811522341999132,0
"['111111', '100', '0', '1011', '0', '01']",17,11,6,0.6470588235294118,0.3529411764705882,4,2,0.9366673818775626,0
"['1010', '1000000', '11011', '100', '001']",22,9,13,0.4090909090909091,0.5909090909090909,2,5,0.9760206482366148,1
"['0', '1', '00110', '0011101']",14,7,7,0.5,0.5,2,2,1.0,0
"['01', '1000010', '01', '10', '00010', '11011', '0']",24,10,14,0.4166666666666667,0.5833333333333334,4,5,0.9798687566511528,0
"['00', '1111', '10', '0', '01100', '00', '0001001', '0000', '1', '1011']",32,13,19,0.40625,0.59375,5,8,0.9744894033980523,0
"['1000111', '0011111', '1100000', '110111', '01', '010001', '1']",36,20,16,0.5555555555555556,0.4444444444444444,7,5,0.9910760598382222,0
"['000000', '0010', '1', '01101', '100', '11001', '1', '10101', '111', '1']",34,17,17,0.5,0.5,6,6,1.0,0
"['00', '110', '0100', '010', '0']",13,4,9,0.3076923076923077,0.6923076923076923,1,4,0.8904916402194913,0
"['0100', '10', '110', '0111']",13,7,6,0.5384615384615384,0.4615384615384615,2,2,0.9957274520849256,1
"['1100', '00', '1001101', '1011', '101110', '11101', '111000', '0011', '1']",39,23,16,0.5897435897435898,0.4102564102564102,9,5,0.97663491144401,0
"['010', '10101', '1000', '0', '00110', '10111', '0010001']",30,13,17,0.4333333333333333,0.5666666666666667,3,5,0.9871377743721864,0
"['0110101', '0110110']",14,8,6,0.5714285714285714,0.4285714285714285,3,0,0.9852281360342516,1
"['10', '0111', '000', '1000']",13,5,8,0.3846153846153846,0.6153846153846154,1,3,0.961236604722876,1
"['0100011', '1100101', '01', '00010', '110110', '00101', '1']",33,16,17,0.4848484848484848,0.5151515151515151,5,4,0.9993375041688848,0
"['111011', '101', '1', '1', '1010100', '101', '01011', '10']",28,18,10,0.6428571428571429,0.3571428571428571,5,1,0.9402859586706313,0
"['0111', '0011001', '100', '010011']",20,10,10,0.5,0.5,4,4,1.0,1
['0'],1,0,1,0.0,1.0,0,0,-0.0,1
"['0111', '11', '01100', '0', '0010101', '110010', '110111', '11111', '110010', '0010011']",49,29,20,0.5918367346938775,0.4081632653061224,11,6,0.9755259511264972,0
"['01', '00', '0000111', '001']",14,5,9,0.3571428571428571,0.6428571428571429,1,4,0.9402859586706313,1
"['0', '11', '0', '1100011']",11,6,5,0.5454545454545454,0.4545454545454545,3,1,0.9940302114769564,0
"['0010110', '0', '101', '011000', '1000']",21,8,13,0.3809523809523809,0.6190476190476191,2,4,0.9587118829771318,0
"['1010010', '111100', '0110001', '11001', '11101', '1111', '11']",36,23,13,0.6388888888888888,0.3611111111111111,9,4,0.943601631299382,0
"['110', '10', '1', '1110', '0000001', '10010', '110', '1', '01']",28,14,14,0.5,0.5,5,4,1.0,0
"['11', '0', '10', '10100', '10111', '10', '10111']",22,14,8,0.6363636363636364,0.3636363636363636,4,1,0.94566030460064,0
"['000', '001']",6,1,5,0.1666666666666666,0.8333333333333334,0,2,0.6500224216483541,1
"['10', '11', '1', '100', '100010', '10', '01', '1011']",22,12,10,0.5454545454545454,0.4545454545454545,4,3,0.9940302114769564,0
['1000001'],7,2,5,0.2857142857142857,0.7142857142857143,0,2,0.863120568566631,1
"['11111', '11', '11']",9,9,0,1.0,0.0,4,0,-0.0,0
"['00101', '100100', '110', '0111111', '100', '01', '10101', '110']",34,19,15,0.5588235294117647,0.4411764705882353,7,5,0.9899927915575186,0
"['00', '001', '01111']",10,5,5,0.5,0.5,2,2,1.0,1
['0100'],4,1,3,0.25,0.75,0,1,0.8112781244591328,1
['1001'],4,2,2,0.5,0.5,0,1,1.0,1
"['00', '10', '100110', '00010', '1100101', '1111000', '010010', '1100010', '101']",45,20,25,0.4444444444444444,0.5555555555555556,5,9,0.9910760598382222,0
"['101110', '001']",9,5,4,0.5555555555555556,0.4444444444444444,1,1,0.9910760598382222,1
"['111011', '11010', '01', '1', '110', '111', '0010110', '010', '1', '0110100']",38,23,15,0.6052631578947368,0.3947368421052631,8,4,0.9677884628267678,0
"['0', '1110011', '1', '111111', '11', '0', '0101000', '01001']",30,18,12,0.6,0.4,6,5,0.9709505944546686,0
"['0011', '10', '011000', '1001', '01', '010101']",24,11,13,0.4583333333333333,0.5416666666666666,2,4,0.99498482818597,0
"['1', '11', '111', '1111', '00001', '0011', '1101', '11001', '101', '010010']",37,23,14,0.6216216216216216,0.3783783783783784,9,5,0.9568886656798212,0
"['010001', '01', '101100', '11', '011011', '0001', '010', '000']",32,14,18,0.4375,0.5625,5,5,0.9886994082884974,0
"['100', '0011', '1011', '11']",13,8,5,0.6153846153846154,0.3846153846153846,3,2,0.961236604722876,1
"['00', '10110', '01', '001', '1100001', '11010', '0000001', '001', '01010']",39,15,24,0.3846153846153846,0.6153846153846154,3,9,0.961236604722876,0
"['100010', '11001', '1100000']",18,7,11,0.3888888888888889,0.6111111111111112,2,4,0.964078764808229,1
"['01', '0100011', '0', '11101', '1010110', '011', '011', '1011', '111110', '11000']",43,26,17,0.6046511627906976,0.3953488372093023,10,3,0.9681647320759544,0
"['110010', '1011000', '11010', '1', '0101110', '1111', '0']",31,18,13,0.5806451612903226,0.4193548387096774,6,2,0.9811522341999132,0
"['101', '0', '101011', '0110110', '00', '001', '0011110', '1', '1']",31,17,14,0.5483870967741935,0.4516129032258064,6,3,0.9932338197397066,0
"['0', '111000', '1001', '01', '01000', '010101', '010', '111100', '000101']",39,17,22,0.4358974358974359,0.5641025641025641,3,6,0.98811083652183,0
"['0111', '0']",5,3,2,0.6,0.4,1,0,0.9709505944546686,1
"['0110', '000000', '1', '1011', '011111', '1000000', '011', '1000', '11101']",40,19,21,0.475,0.525,8,7,0.99819587904281,0
"['00010', '1010', '10110', '1000', '0001101', '1']",26,11,15,0.4230769230769231,0.5769230769230769,3,4,0.9828586897127056,1
"['1111', '11', '100', '0100', '101100', '1001', '01', '01110', '000000']",36,17,19,0.4722222222222222,0.5277777777777778,5,7,0.997772472089982,0
"['0101', '101', '001010', '110011', '0001', '0000', '1']",28,12,16,0.4285714285714285,0.5714285714285714,3,5,0.9852281360342516,1
"['00011', '111010', '111100']",17,10,7,0.5882352941176471,0.4117647058823529,4,2,0.9774178175281716,1
"['000010', '1', '11001', '000', '1', '101100', '0']",23,9,14,0.391304347826087,0.6086956521739131,3,5,0.9656361333706098,0
"['0101111', '11']",9,7,2,0.7777777777777778,0.2222222222222222,3,0,0.7642045065086203,1
"['001', '01101', '010']",11,5,6,0.4545454545454545,0.5454545454545454,1,1,0.9940302114769564,1
"['10000', '1011110', '10100']",17,8,9,0.4705882352941176,0.5294117647058824,2,3,0.9975025463691152,1
['0101'],4,2,2,0.5,0.5,0,0,1.0,1
"['11', '1111', '000111']",12,9,3,0.75,0.25,4,1,0.8112781244591328,0
"['11', '001101', '001', '0101', '100', '10']",20,10,10,0.5,0.5,3,3,1.0,1
"['11111', '00011', '01', '1101101', '0101111']",26,18,8,0.6923076923076923,0.3076923076923077,7,1,0.8904916402194913,1
"['10', '111011']",8,6,2,0.75,0.25,2,0,0.8112781244591328,1
"['10', '0110000', '00000', '000', '1010', '1110']",25,8,17,0.32,0.68,2,7,0.9043814577244936,0
"['0000', '110']",7,2,5,0.2857142857142857,0.7142857142857143,1,2,0.863120568566631,1
"['1', '111', '111000', '100111']",16,11,5,0.6875,0.3125,4,2,0.8960382325345574,0
['101111'],6,5,1,0.8333333333333334,0.1666666666666666,2,0,0.6500224216483541,1
"['011', '010']",6,3,3,0.5,0.5,1,0,1.0,1
"['010', '0110111', '101']",13,8,5,0.6153846153846154,0.3846153846153846,3,1,0.961236604722876,1
"['1001', '100110', '101', '00', '00', '01', '001', '0100000']",29,10,19,0.3448275862068966,0.6551724137931034,2,7,0.9293636260137188,0
"['00', '0101', '1', '1']",8,4,4,0.5,0.5,1,1,1.0,1
"['010', '1011010', '00011', '1010101', '11', '1010011', '1111101']",38,23,15,0.6052631578947368,0.3947368421052631,7,3,0.9677884628267678,0
"['000', '1', '00', '0010', '00', '11001', '1110001', '0', '10011']",30,12,18,0.4,0.6,4,7,0.9709505944546686,0
"['1111010', '00001', '11010', '1010', '10', '0100', '1100111']",34,18,16,0.5294117647058824,0.4705882352941176,5,5,0.9975025463691152,0
"['0000110', '1011101', '10000', '000']",22,8,14,0.3636363636363636,0.6363636363636364,3,5,0.94566030460064,1
"['11', '1001', '000111', '010001', '1011010', '1100110', '0', '11']",35,19,16,0.5428571428571428,0.4571428571428571,7,5,0.9946937953613058,0
"['11', '0011011', '011101']",15,10,5,0.6666666666666666,0.3333333333333333,4,1,0.9182958340544896,1
"['0', '001001', '0', '0010000', '001', '101100']",24,7,17,0.2916666666666667,0.7083333333333334,2,7,0.8708644692353644,0
"['1000', '1', '0111', '11', '1111', '01000', '1000100', '001010', '101011']",39,20,19,0.5128205128205128,0.4871794871794871,5,5,0.999525689293649,0
"['00000', '010', '00111', '00001', '0001000', '110', '01110', '10011', '100', '1001']",45,17,28,0.3777777777777777,0.6222222222222222,4,12,0.9564574047992594,0
"['01', '01', '1001010']",11,5,6,0.4545454545454545,0.5454545454545454,1,1,0.9940302114769564,1
"['1001110', '10']",9,5,4,0.5555555555555556,0.4444444444444444,1,1,0.9910760598382222,1
"['1', '110', '10', '01010', '00100', '0001']",20,8,12,0.4,0.6,1,4,0.9709505944546686,0
"['0', '11100', '1', '0010', '0000', '0000', '1010', '0', '111010', '0011001']",37,14,23,0.3783783783783784,0.6216216216216216,3,9,0.9568886656798212,0
"['0000', '101101', '011', '01']",15,7,8,0.4666666666666667,0.5333333333333333,2,2,0.9967916319816366,0
"['0', '11011', '10', '01']",10,6,4,0.6,0.4,2,1,0.9709505944546686,0
"['100', '1', '001110', '010']",13,6,7,0.4615384615384615,0.5384615384615384,1,3,0.9957274520849256,1
"['10111', '1011110', '01110']",17,12,5,0.7058823529411765,0.2941176470588235,5,1,0.8739810481273578,1
"['0010', '010', '0010', '011', '010', '0101', '0011', '0', '101101', '100']",35,15,20,0.4285714285714285,0.5714285714285714,4,7,0.9852281360342516,0
"['1011011', '1', '010', '0101010', '1', '11110', '01', '100', '1111001']",36,22,14,0.6111111111111112,0.3888888888888889,7,4,0.964078764808229,0
"['101111', '1010101', '011101', '1', '1010', '0000', '00']",30,16,14,0.5333333333333333,0.4666666666666667,4,3,0.9967916319816366,0
"['1111100', '1011', '0101', '1', '10']",18,12,6,0.6666666666666666,0.3333333333333333,4,1,0.9182958340544896,0
"['111101', '110', '001110', '01011', '0000', '000110', '010', '0110011']",40,20,20,0.5,0.5,8,8,1.0,0
"['001101', '10000', '01101', '11', '10110', '00011', '110101']",34,18,16,0.5294117647058824,0.4705882352941176,8,5,0.9975025463691152,1
"['0111001', '0000', '001001', '010', '000']",23,7,16,0.3043478260869565,0.6956521739130435,1,7,0.8865408928220899,0
"['1001001', '0101100', '0000101', '0001', '101001', '00111']",36,15,21,0.4166666666666667,0.5833333333333334,3,8,0.9798687566511528,1
"['1', '000', '0001010']",11,3,8,0.2727272727272727,0.7272727272727273,0,3,0.8453509366224364,1
"['0010101', '1110101', '0010000', '100000', '1110111', '111']",37,19,18,0.5135135135135135,0.4864864864864865,6,6,0.9994730201859836,1
['0101'],4,2,2,0.5,0.5,0,0,1.0,1
"['01', '000011']",8,3,5,0.375,0.625,1,2,0.954434002924965,1
"['010', '000', '00']",8,1,7,0.125,0.875,0,3,0.5435644431995964,0
"['01110', '01001', '000100', '110', '1', '111000', '1010', '00', '01', '010']",37,16,21,0.4324324324324324,0.5675675675675675,4,7,0.9867867202680318,0
"['11', '101011', '100000', '11', '010', '11010', '111', '11']",29,18,11,0.6206896551724138,0.3793103448275862,6,2,0.9575534837147482,0
"['0011001', '011']",10,5,5,0.5,0.5,2,2,1.0,1
"['10010', '1001011', '1101010', '1010100', '000111', '00010', '11', '011100']",45,22,23,0.4888888888888889,0.5111111111111111,5,6,0.999643749677856,0
"['001', '100', '1', '1', '0100111', '00', '001', '0', '110']",24,11,13,0.4583333333333333,0.5416666666666666,4,5,0.99498482818597,0
"['1001011', '00', '1011101']",16,9,7,0.5625,0.4375,2,2,0.9886994082884974,1
"['1111', '010111', '01', '0', '000', '010', '0001111', '10111', '1', '1011']",36,22,14,0.6111111111111112,0.3888888888888889,8,4,0.964078764808229,0
"['00110', '00', '1', '010001']",14,5,9,0.3571428571428571,0.6428571428571429,1,3,0.9402859586706313,1
"['001', '01000', '1', '010011', '00011', '110100', '10']",28,12,16,0.4285714285714285,0.5714285714285714,3,5,0.9852281360342516,0
"['1110000', '1111', '01', '110', '00001']",21,11,10,0.5238095238095238,0.4761904761904761,4,4,0.998363672593813,1
['000001'],6,1,5,0.1666666666666666,0.8333333333333334,0,2,0.6500224216483541,1
"['1110011', '0010111', '001', '0100', '0000', '11', '000011', '0001010']",40,17,23,0.425,0.575,5,9,0.983708262623186,0
['011111'],6,5,1,0.8333333333333334,0.1666666666666666,2,0,0.6500224216483541,1
"['10', '010', '1', '10', '1101', '00010', '0100', '1', '1110', '00']",28,13,15,0.4642857142857143,0.5357142857142857,4,5,0.996316519558962,0
"['100000', '0110', '10000']",15,4,11,0.2666666666666666,0.7333333333333333,1,5,0.8366407419411672,1
"['1101001', '110110', '1']",14,9,5,0.6428571428571429,0.3571428571428571,3,1,0.9402859586706313,1
"['0', '1', '110', '100']",8,4,4,0.5,0.5,1,1,1.0,0
"['0101', '0101100', '1000']",15,6,9,0.4,0.6,1,2,0.9709505944546686,1
"['0110100', '0011110', '00', '001101', '10', '0011', '1010000', '110010', '111111']",47,24,23,0.5106382978723404,0.4893617021276595,10,8,0.9996734260048916,0
['011'],3,2,1,0.6666666666666666,0.3333333333333333,1,0,0.9182958340544896,1
"['110', '0101001', '101010', '1', '001', '1101010', '10', '101', '1010']",36,19,17,0.5277777777777778,0.4722222222222222,4,3,0.997772472089982,0
"['0101', '000', '00']",9,2,7,0.2222222222222222,0.7777777777777778,0,2,0.7642045065086203,0
"['0000011', '11110', '00', '101001', '1', '0001001']",28,12,16,0.4285714285714285,0.5714285714285714,4,6,0.9852281360342516,0
"['11', '011011', '11100', '110111', '01', '111']",24,18,6,0.75,0.25,8,1,0.8112781244591328,0
"['00010', '0', '1010100', '01', '00', '0']",18,5,13,0.2777777777777778,0.7222222222222222,0,4,0.8524051786494786,0
"['1001', '011000', '01']",12,5,7,0.4166666666666667,0.5833333333333334,1,3,0.9798687566511528,1
"['100', '11100', '1', '11', '0111011', '100001', '111111']",30,20,10,0.6666666666666666,0.3333333333333333,7,4,0.9182958340544896,0
"['00', '011110', '100111', '0111100', '11101', '110', '01', '0', '01']",34,20,14,0.5882352941176471,0.4117647058823529,7,5,0.9774178175281716,0
"['110', '1', '0000100', '0101', '110011', '1101101', '00', '0111', '1', '000110']",41,21,20,0.5121951219512195,0.4878048780487805,8,6,0.9995708393473224,0
"['11', '111011']",8,7,1,0.875,0.125,3,0,0.5435644431995964,1
"['1010', '110', '000', '1111100', '0010', '001']",24,11,13,0.4583333333333333,0.5416666666666666,3,5,0.99498482818597,1
"['010', '11', '0', '1111010', '00001', '00100', '1', '10', '0110110', '11']",35,18,17,0.5142857142857142,0.4857142857142857,7,5,0.9994110647387552,0
"['0', '000100', '1', '1101111', '0', '010', '0']",20,9,11,0.45,0.55,3,5,0.9927744539878084,0
"['001', '0000', '11', '110101', '110101', '0000']",25,11,14,0.44,0.56,3,5,0.9895875212220556,1
"['1101', '11001', '1001110', '1', '110100', '0011', '0000', '000', '0111', '1001']",42,21,21,0.5,0.5,8,9,1.0,0
"['1101011', '010', '00', '10101', '00110', '11', '11', '1']",27,16,11,0.5925925925925926,0.4074074074074074,5,2,0.975119064940866,0
"['0111', '0101', '10111']",13,9,4,0.6923076923076923,0.3076923076923077,3,0,0.8904916402194913,1
"['1111', '11']",6,6,0,1.0,0.0,3,0,-0.0,0
"['100', '010', '1', '001100', '011110', '0011111', '0']",27,14,13,0.5185185185185185,0.4814814814814814,5,4,0.9990102708804812,0
"['0001011', '11110', '011001', '001110']",24,13,11,0.5416666666666666,0.4583333333333333,5,4,0.99498482818597,1
"['00', '0', '10110', '0', '00', '01101', '01010', '1110011']",28,13,15,0.4642857142857143,0.5357142857142857,4,4,0.996316519558962,0
"['11', '00', '11', '10111', '0001101', '1', '100011']",25,15,10,0.6,0.4,6,3,0.9709505944546686,0
"['1110011', '111111', '0', '10', '01', '110', '00011', '0', '1110101']",34,22,12,0.6470588235294118,0.3529411764705882,8,4,0.9366673818775626,0
"['100110', '11', '11', '0', '0001', '011', '01011', '1']",24,14,10,0.5833333333333334,0.4166666666666667,5,3,0.9798687566511528,0
"['11', '0', '0111110', '0000', '1100']",18,9,9,0.5,0.5,4,4,1.0,0
"['010', '1', '010', '1', '11', '01010', '110', '1001', '0110']",26,14,12,0.5384615384615384,0.4615384615384615,3,1,0.9957274520849256,0
"['100100', '100110', '01']",14,6,8,0.4285714285714285,0.5714285714285714,1,4,0.9852281360342516,1
['1100010'],7,3,4,0.4285714285714285,0.5714285714285714,1,1,0.9852281360342516,1
"['0', '11101', '010', '001000', '111111', '100111', '1011001', '0']",35,20,15,0.5714285714285714,0.4285714285714285,7,4,0.9852281360342516,0
"['1', '10']",3,2,1,0.6666666666666666,0.3333333333333333,1,0,0.9182958340544896,1
"['00101', '000101']",11,4,7,0.3636363636363636,0.6363636363636364,0,2,0.94566030460064,1
"['1100110', '011001', '0101', '0100110', '11011']",29,16,13,0.5517241379310345,0.4482758620689655,6,4,0.9922666387194964,1
"['01010', '0', '110110', '011000', '010']",21,9,12,0.4285714285714285,0.5714285714285714,3,4,0.9852281360342516,1
"['001010', '1']",7,3,4,0.4285714285714285,0.5714285714285714,0,1,0.9852281360342516,1
"['110', '11100', '010100', '0001']",18,8,10,0.4444444444444444,0.5555555555555556,2,3,0.9910760598382222,1
"['1101', '0010', '000', '0', '1', '1100', '1010101', '010']",27,12,15,0.4444444444444444,0.5555555555555556,2,4,0.9910760598382222,0
"['111010', '111', '000', '101', '01', '00101', '0100', '0111010', '1100010', '1001101']",47,24,23,0.5106382978723404,0.4893617021276595,5,5,0.9996734260048916,0
"['101', '1']",4,3,1,0.75,0.25,1,0,0.8112781244591328,1
"['011011', '11', '0']",9,6,3,0.6666666666666666,0.3333333333333333,3,0,0.9182958340544896,0
"['111', '10', '00', '010101', '110101', '0101010', '0000', '1', '1111']",35,19,16,0.5428571428571428,0.4571428571428571,5,4,0.9946937953613058,0
"['110011', '011101', '01100', '11', '0001010']",26,14,12,0.5384615384615384,0.4615384615384615,5,3,0.9957274520849256,1
"['0', '1001', '01011']",10,5,5,0.5,0.5,1,1,1.0,1
"['01111', '0']",6,4,2,0.6666666666666666,0.3333333333333333,2,0,0.9182958340544896,1
"['1', '1110', '1101111', '0', '110', '01011', '0', '11', '11101', '01']",31,22,9,0.7096774193548387,0.2903225806451613,9,1,0.869137580612638,0
"['0', '0', '100111', '1101', '111', '111', '100100', '10100']",29,17,12,0.5862068965517241,0.4137931034482758,6,5,0.9784493292686188,1
"['1101010', '10101', '1000', '0100', '111000', '10', '001', '0000', '010', '00']",40,15,25,0.375,0.625,3,8,0.954434002924965,0
"['100100', '10001', '110', '1011']",18,9,9,0.5,0.5,2,3,1.0,1
"['1111111', '001', '0010110', '0', '0010110', '000']",28,14,14,0.5,0.5,5,6,1.0,0
"['011000', '1001', '00']",12,4,8,0.3333333333333333,0.6666666666666666,1,3,0.9182958340544896,1
"['100100', '0100', '110', '10000', '0011001', '011', '000']",31,11,20,0.3548387096774194,0.6451612903225806,3,8,0.9383153522334068,1
"['11001', '1111001', '10100', '0100100', '0110', '001000', '110001']",40,18,22,0.45,0.55,6,8,0.9927744539878084,1
"['0111011', '1']",8,6,2,0.75,0.25,2,0,0.8112781244591328,1
"['00', '010101', '0', '11101']",14,7,7,0.5,0.5,1,1,1.0,0
"['110101', '1000111', '1', '000100']",20,10,10,0.5,0.5,4,3,1.0,1
"['11', '011100', '0110101', '00', '1101', '011011']",27,16,11,0.5925925925925926,0.4074074074074074,6,2,0.975119064940866,0
"['1000101', '1000010', '11', '00', '110', '10']",23,10,13,0.4347826086956521,0.5652173913043478,3,4,0.9876925088958034,0
"['10011', '101010']",11,6,5,0.5454545454545454,0.4545454545454545,1,1,0.9940302114769564,1
['01'],2,1,1,0.5,0.5,0,0,1.0,1
"['0001', '1101', '1000000', '111010', '10', '00000', '0100100']",35,12,23,0.3428571428571428,0.6571428571428571,3,9,0.927526588431676,0
"['1110', '010110', '1101100', '10']",19,11,8,0.5789473684210527,0.4210526315789473,4,2,0.9819407868640976,1
"['0011010', '001001', '00111', '0', '11', '1001', '1011001', '110', '01101']",40,21,19,0.525,0.475,7,7,0.99819587904281,0
"['0110', '00']",6,2,4,0.3333333333333333,0.6666666666666666,1,1,0.9182958340544896,1
"['01', '11', '10111', '1110', '11101', '100', '0011011', '0']",29,19,10,0.6551724137931034,0.3448275862068966,9,2,0.9293636260137188,0
"['1110111', '01011', '1110000', '0110', '0111', '1101', '110001', '1', '1']",39,25,14,0.6410256410256411,0.358974358974359,9,4,0.9418285354475155,0
"['100', '0101011', '0', '01', '101', '10000', '0011110', '01']",30,14,16,0.4666666666666667,0.5333333333333333,5,6,0.9967916319816366,0
"['1000', '001001', '001']",13,4,9,0.3076923076923077,0.6923076923076923,0,4,0.8904916402194913,0
"['1111110', '0010']",11,7,4,0.6363636363636364,0.3636363636363636,3,1,0.94566030460064,1
"['01', '0011110', '0', '10', '0001011', '110010', '11']",27,14,13,0.5185185185185185,0.4814814814814814,5,5,0.9990102708804812,0
"['0101010', '1', '01110', '110', '1', '1100', '0', '11011', '0']",28,16,12,0.5714285714285714,0.4285714285714285,5,1,0.9852281360342516,0
"['10', '10101', '1110', '001111', '000', '111001', '0011', '0', '001111', '0110010']",44,24,20,0.5454545454545454,0.4545454545454545,9,6,0.9940302114769564,0
"['0', '01', '1', '101001', '1001', '000101', '100111', '1010010']",33,16,17,0.4848484848484848,0.5151515151515151,5,6,0.9993375041688848,0
"['010001', '101']",9,4,5,0.4444444444444444,0.5555555555555556,1,1,0.9910760598382222,1
"['001011', '011111']",12,8,4,0.6666666666666666,0.3333333333333333,3,1,0.9182958340544896,1
"['000111', '1', '1110000', '010']",17,8,9,0.4705882352941176,0.5294117647058824,3,3,0.9975025463691152,1
"['0', '0010000', '0110', '1110000', '00111', '0001100', '101111', '0001011', '001', '001']",50,21,29,0.42,0.58,7,11,0.9814538950336535,0
"['100101', '1010', '00', '100']",15,6,9,0.4,0.6,1,3,0.9709505944546686,1
"['010000', '00000', '10001', '1111011', '1101', '1110', '10', '10011']",38,19,19,0.5,0.5,7,6,1.0,1
"['0000', '11001']",9,3,6,0.3333333333333333,0.6666666666666666,1,3,0.9182958340544896,1
"['1011', '0110001', '011', '00', '0101', '000000', '0001010']",33,12,21,0.3636363636363636,0.6363636363636364,3,6,0.94566030460064,0
"['0101', '1100', '11', '100101', '000', '11', '1100', '11000', '010', '1']",34,17,17,0.5,0.5,5,6,1.0,0
"['1011', '01', '0101101', '01111', '1011100', '00', '1111011', '110010', '00', '0100111']",49,29,20,0.5918367346938775,0.4081632653061224,10,6,0.9755259511264972,0
"['011', '0000100', '011', '1100111', '101111', '1001', '10001']",35,19,16,0.5428571428571428,0.4571428571428571,8,6,0.9946937953613058,1
"['00111', '0001', '11100', '10001', '01']",21,10,11,0.4761904761904761,0.5238095238095238,3,4,0.998363672593813,1
"['0111', '01000', '011', '1011', '1111100', '10100', '001', '0111']",35,20,15,0.5714285714285714,0.4285714285714285,6,5,0.9852281360342516,0
"['1101110', '01', '011', '10', '010', '011101', '110']",26,16,10,0.6153846153846154,0.3846153846153846,5,3,0.961236604722876,0
"['000', '11101', '1000000', '0010', '1101', '100100', '0110']",33,13,20,0.3939393939393939,0.6060606060606061,5,7,0.9672947789468944,1
"['101000', '10', '1', '010000']",15,5,10,0.3333333333333333,0.6666666666666666,0,3,0.9182958340544896,1
"['0', '0011011', '00', '11', '11101', '11', '11', '1001101', '0']",29,18,11,0.6206896551724138,0.3793103448275862,8,3,0.9575534837147482,0
"['0', '0', '11110', '1', '01100']",13,7,6,0.5384615384615384,0.4615384615384615,3,2,0.9957274520849256,0
"['011110', '10011', '001', '0', '01110']",20,11,9,0.55,0.45,4,3,0.9927744539878084,1
['011'],3,2,1,0.6666666666666666,0.3333333333333333,1,0,0.9182958340544896,1
"['000010', '0011', '0', '10001', '0', '101101', '10101']",28,12,16,0.4285714285714285,0.5714285714285714,3,4,0.9852281360342516,1
"['10010', '11000', '0101', '1011', '0101111', '0001', '1110']",33,18,15,0.5454545454545454,0.4545454545454545,7,4,0.9940302114769564,1
"['011', '0011', '0111011', '111', '1010100', '01']",26,16,10,0.6153846153846154,0.3846153846153846,6,2,0.961236604722876,1
"['00101', '01010', '10', '01', '11', '101000', '0001111', '10111']",34,18,16,0.5294117647058824,0.4705882352941176,5,5,0.9975025463691152,0
"['010', '01', '1100110', '1110', '0100010', '100', '0011', '001']",33,15,18,0.4545454545454545,0.5454545454545454,4,7,0.9940302114769564,0
"['1011', '110110', '1', '01', '10011', '111', '1011', '000011', '0']",32,20,12,0.625,0.375,9,3,0.954434002924965,0
['1000'],4,1,3,0.25,0.75,0,1,0.8112781244591328,1
"['0101001', '1111100', '1010', '00', '001', '111011']",29,16,13,0.5517241379310345,0.4482758620689655,6,4,0.9922666387194964,1
"['001', '0', '11', '10', '0110', '10110']",17,9,8,0.5294117647058824,0.4705882352941176,3,2,0.9975025463691152,0
"['10011', '10100', '00110', '10', '10', '011', '0111', '1100110', '0101']",37,20,17,0.5405405405405406,0.4594594594594595,6,6,0.9952525494396792,0
['0110010'],7,3,4,0.4285714285714285,0.5714285714285714,1,1,0.9852281360342516,1
"['1110011', '10', '1000', '000111', '0100011', '0000', '1100', '1001000']",41,17,24,0.4146341463414634,0.5853658536585366,5,10,0.9788698505067784,1
['11001'],5,3,2,0.6,0.4,1,1,0.9709505944546686,1
"['00100', '111100', '010101', '1000010', '000110']",30,12,18,0.4,0.6,4,7,0.9709505944546686,1
"['00111', '0100', '0', '01', '0001', '10101', '110110', '00', '0111100']",36,17,19,0.4722222222222222,0.5277777777777778,6,7,0.997772472089982,0
['010'],3,1,2,0.3333333333333333,0.6666666666666666,0,0,0.9182958340544896,1
"['1', '11', '1']",4,4,0,1.0,0.0,2,0,-0.0,0
['0101'],4,2,2,0.5,0.5,0,0,1.0,1
"['10100', '101', '110111', '0011101', '1110', '10']",27,17,10,0.6296296296296297,0.3703703703703703,5,2,0.9509560484549724,0
"['0', '000', '111', '000', '0000011', '1011']",21,8,13,0.3809523809523809,0.6190476190476191,3,6,0.9587118829771318,0
"['111100', '110', '1101', '0010110', '100', '001100', '01110', '011', '0111']",41,23,18,0.5609756097560976,0.4390243902439024,9,6,0.9892452969285004,0
"['0', '0011', '1010', '111100', '001101', '1110', '0', '111111', '11']",34,22,12,0.6470588235294118,0.3529411764705882,10,4,0.9366673818775626,0
"['10001', '100', '0100010', '10001', '10101', '10100', '1111001']",37,17,20,0.4594594594594595,0.5405405405405406,5,6,0.9952525494396792,1
"['010100', '01110', '01111', '1010110', '01', '1011101', '1101']",36,22,14,0.6111111111111112,0.3888888888888889,7,3,0.964078764808229,0
"['1101', '011', '010', '111101', '11', '1110000', '1110111', '110000', '101', '00']",43,26,17,0.6046511627906976,0.3953488372093023,10,5,0.9681647320759544,0
"['110110', '1']",7,5,2,0.7142857142857143,0.2857142857142857,2,0,0.863120568566631,1
"['100', '1100000', '0', '0011101', '1011']",22,10,12,0.4545454545454545,0.5454545454545454,4,5,0.9940302114769564,1
"['0100111', '11', '1101', '01', '0000000', '11011', '01110', '1', '100010']",39,20,19,0.5128205128205128,0.4871794871794871,7,5,0.999525689293649,0
"['101', '0010', '00', '0101', '01111', '1001', '01']",24,12,12,0.5,0.5,2,4,1.0,0
"['1011100', '10111', '00', '110', '000010', '100100', '1011', '111111']",39,22,17,0.5641025641025641,0.4358974358974359,7,6,0.98811083652183,0
"['000', '00']",5,0,5,0.0,1.0,0,2,-0.0,0
"['10', '00']",4,1,3,0.25,0.75,0,1,0.8112781244591328,1
"['1100', '1010000', '10']",13,5,8,0.3846153846153846,0.6153846153846154,1,3,0.961236604722876,1
"['1000', '0', '0011110', '0000', '0010', '1010100']",27,9,18,0.3333333333333333,0.6666666666666666,2,7,0.9182958340544896,0
"['0111011', '110', '0010010', '0', '0111111', '0011']",29,17,12,0.5862068965517241,0.4137931034482758,7,4,0.9784493292686188,0
"['0', '100010', '00', '1110111', '0100111', '10', '1', '1111011']",33,20,13,0.6060606060606061,0.3939393939393939,7,3,0.9672947789468944,0
"['11100', '01', '00111']",12,7,5,0.5833333333333334,0.4166666666666667,2,2,0.9798687566511528,1
"['1001000', '101', '00111', '001110', '10', '1', '1']",25,13,12,0.52,0.48,3,4,0.9988455359952018,0
"['011', '0', '101001', '00101']",15,7,8,0.4666666666666667,0.5333333333333333,1,2,0.9967916319816366,1
"['011', '0', '0110', '00000', '10000', '000110', '01001']",29,9,20,0.3103448275862069,0.6896551724137931,3,9,0.8935711016541907,0
"['101001', '10', '1011']",12,7,5,0.5833333333333334,0.4166666666666667,2,1,0.9798687566511528,1
"['11001', '10']",7,4,3,0.5714285714285714,0.4285714285714285,2,1,0.9852281360342516,1
['01111'],5,4,1,0.8,0.2,2,0,0.7219280948873623,1
"['010000', '1100111', '111000', '0']",20,9,11,0.45,0.55,4,5,0.9927744539878084,1
"['1', '1111101', '00100', '11011', '00100', '1110', '0111110', '0010']",38,22,16,0.5789473684210527,0.4210526315789473,8,6,0.9819407868640976,0
"['11000', '1111', '10101', '110000', '1101101', '01110', '101', '0010101']",42,24,18,0.5714285714285714,0.4285714285714285,7,4,0.9852281360342516,0
['111000'],6,3,3,0.5,0.5,1,1,1.0,1
"['111100', '0110011', '011101', '10001', '10111']",29,18,11,0.6206896551724138,0.3793103448275862,8,3,0.9575534837147482,1
"['0000', '01100']",9,2,7,0.2222222222222222,0.7777777777777778,1,3,0.7642045065086203,1
"['011100', '1010', '0101101', '011', '110', '0', '0000', '0011']",32,15,17,0.46875,0.53125,5,6,0.9971803988942642,0
"['101111', '01', '0']",9,6,3,0.6666666666666666,0.3333333333333333,2,0,0.9182958340544896,1
"['011111', '1101', '1010100']",17,11,6,0.6470588235294118,0.3529411764705882,4,1,0.9366673818775626,1
"['0011', '0111001', '10010', '1', '01', '00']",21,10,11,0.4761904761904761,0.5238095238095238,3,4,0.998363672593813,0
"['10100', '1', '1', '0011', '0100100', '0100111', '1', '100011', '0', '10110']",38,19,19,0.5,0.5,6,6,1.0,0
"['1000', '111010', '1001101', '0', '1111', '10', '1', '1110111', '111']",35,24,11,0.6857142857142857,0.3142857142857143,9,2,0.898058793450166,0
['1000'],4,1,3,0.25,0.75,0,1,0.8112781244591328,1
"['0100', '1', '0010010', '1011', '11010', '101', '0', '110', '0110', '01101']",37,19,18,0.5135135135135135,0.4864864864864865,5,5,0.9994730201859836,0
['01010'],5,2,3,0.4,0.6,0,0,0.9709505944546686,1
"['01', '10']",4,2,2,0.5,0.5,1,0,1.0,1
"['0', '01', '1100', '000110', '0110101', '00001', '01011']",30,13,17,0.4333333333333333,0.5666666666666667,4,6,0.9871377743721864,0
"['1101', '111', '000']",10,6,4,0.6,0.4,3,1,0.9709505944546686,1
"['1011', '1111', '01000', '0000100', '1101', '1']",25,13,12,0.52,0.48,5,4,0.9988455359952018,0
"['101', '010', '01011']",11,6,5,0.5454545454545454,0.4545454545454545,1,1,0.9940302114769564,1
"['0', '1', '0', '11011', '1000111', '001001']",21,11,10,0.5238095238095238,0.4761904761904761,3,3,0.998363672593813,0
"['0', '1001', '000', '0010101', '110100', '1010', '01010', '100011', '01010']",41,17,24,0.4146341463414634,0.5853658536585366,2,6,0.9788698505067784,0
['111010'],6,4,2,0.6666666666666666,0.3333333333333333,1,0,0.9182958340544896,1
"['101110', '001', '11001', '0000011']",21,10,11,0.4761904761904761,0.5238095238095238,3,4,0.998363672593813,1
['0001'],4,1,3,0.25,0.75,0,1,0.8112781244591328,1
"['101011', '100010', '11101', '1', '110', '00101', '11', '11']",30,19,11,0.6333333333333333,0.3666666666666666,6,2,0.9480782435939056,0
"['00', '11100', '011', '1100']",14,7,7,0.5,0.5,3,3,1.0,1
"['10001', '0']",6,2,4,0.3333333333333333,0.6666666666666666,0,1,0.9182958340544896,1
"['111101', '001001', '00']",14,7,7,0.5,0.5,2,3,1.0,1
"['0', '10001', '1100000', '1001', '0', '011101']",24,10,14,0.4166666666666667,0.5833333333333334,2,5,0.9798687566511528,1
"['00011', '11100', '10', '01110', '001', '1', '110100', '01101', '0100', '0']",37,18,19,0.4864864864864865,0.5135135135135135,6,6,0.9994730201859836,0
"['10010', '010100', '0010111', '1110', '111', '111', '1100100', '111011', '101']",44,27,17,0.6136363636363636,0.3863636363636363,9,6,0.9624127354629924,0
"['1', '101', '00100', '0010101', '010110', '0', '0001010']",30,12,18,0.4,0.6,2,5,0.9709505944546686,0
"['0110', '010111', '10', '1010', '1100100', '11101', '0101101', '0111100']",42,24,18,0.5714285714285714,0.4285714285714285,8,4,0.9852281360342516,0
"['1110', '10', '01011', '010110']",17,10,7,0.5882352941176471,0.4117647058823529,3,1,0.9774178175281716,0
"['01', '1', '100001', '100', '011011']",18,9,9,0.5,0.5,4,3,1.0,0
"['110', '0010011', '11000', '0', '1010010', '10100', '001101', '01', '10001', '0']",42,18,24,0.4285714285714285,0.5714285714285714,5,8,0.9852281360342516,0
"['1110101', '101010', '001000', '10001']",24,11,13,0.4583333333333333,0.5416666666666666,2,3,0.99498482818597,1
"['0', '01', '01']",5,2,3,0.4,0.6,0,1,0.9709505944546686,1
"['01', '11', '11000', '001010', '10101']",20,10,10,0.5,0.5,2,2,1.0,1
['110001'],6,3,3,0.5,0.5,1,1,1.0,1
"['11011', '1111001', '110110', '00', '100110', '00011', '110']",34,20,14,0.5882352941176471,0.4117647058823529,9,5,0.9774178175281716,0
"['0011011', '101']",10,6,4,0.6,0.4,2,1,0.9709505944546686,1
"['1010001', '1101111', '1100']",18,11,7,0.6111111111111112,0.3888888888888889,4,2,0.964078764808229,1
"['11', '1', '00', '001', '1100010', '11', '0', '00000']",23,9,14,0.391304347826087,0.6086956521739131,3,6,0.9656361333706098,0
"['01110', '01', '0', '011101', '00001', '111', '00000', '10', '1111', '01001']",38,19,19,0.5,0.5,6,7,1.0,0
"['1111', '1000', '10100']",13,7,6,0.5384615384615384,0.4615384615384615,2,2,0.9957274520849256,1
"['0101000', '01', '0000110', '110011', '000']",25,9,16,0.36,0.64,3,6,0.9426831892554922,0
"['010111', '111', '00', '110', '01', '01011']",21,13,8,0.6190476190476191,0.3809523809523809,5,2,0.9587118829771318,1
"['010', '010111', '1000']",13,6,7,0.4615384615384615,0.5384615384615384,2,2,0.9957274520849256,1
['001'],3,1,2,0.3333333333333333,0.6666666666666666,0,1,0.9182958340544896,1
"['0011', '01011']",9,5,4,0.5555555555555556,0.4444444444444444,2,1,0.9910760598382222,1
"['100', '001', '01', '1', '1', '0000001', '000111', '11000', '0011110', '1101']",39,18,21,0.4615384615384615,0.5384615384615384,6,8,0.9957274520849256,0
"['01', '0', '110010', '00110', '110']",17,8,9,0.4705882352941176,0.5294117647058824,3,2,0.9975025463691152,0
"['001', '10', '11', '0101011', '11000']",19,10,9,0.5263157894736842,0.4736842105263157,4,2,0.9980008838722996,1
"['1000011', '00', '000100', '1', '10', '0010010', '011', '1']",29,11,18,0.3793103448275862,0.6206896551724138,3,8,0.9575534837147482,0
"['010', '0110', '111', '011', '0', '00001', '10', '011100', '11011']",32,17,15,0.53125,0.46875,7,5,0.9971803988942642,0
"['0', '00', '1101', '0100100']",14,5,9,0.3571428571428571,0.6428571428571429,1,3,0.9402859586706313,0
['10'],2,1,1,0.5,0.5,0,0,1.0,1
"['1', '1100', '0100', '001']",12,5,7,0.4166666666666667,0.5833333333333334,1,3,0.9798687566511528,0
"['111100', '01000', '1010000', '001101', '1', '00', '0001', '10001']",36,14,22,0.3888888888888889,0.6111111111111112,5,8,0.964078764808229,0
"['00', '000011', '1101', '0111', '10100', '01001', '1110', '100']",33,16,17,0.4848484848484848,0.5151515151515151,6,6,0.9993375041688848,0
"['10011', '0', '1', '1010001', '111011', '1111']",24,16,8,0.6666666666666666,0.3333333333333333,7,2,0.9182958340544896,0
"['0', '0001010', '0', '0000', '01001', '10111']",23,8,15,0.3478260869565217,0.6521739130434783,2,6,0.9321115676166748,0
"['0001100', '0', '110111', '1101', '100000', '10', '1', '01111', '01000']",37,18,19,0.4864864864864865,0.5135135135135135,7,5,0.9994730201859836,0
"['01000', '11', '0010']",11,4,7,0.3636363636363636,0.6363636363636364,1,2,0.94566030460064,1
"['1', '1011', '0']",6,4,2,0.6666666666666666,0.3333333333333333,2,0,0.9182958340544896,0
"['001011', '1001001', '10101', '110001', '1110011', '1001010', '10101', '01', '01001']",50,26,24,0.52,0.48,6,7,0.9988455359952018,0
"['11011', '0']",6,4,2,0.6666666666666666,0.3333333333333333,2,0,0.9182958340544896,1
"['1100010', '1111010']",14,8,6,0.5714285714285714,0.4285714285714285,3,1,0.9852281360342516,1
"['0111111', '1011', '101', '001011', '0000', '1111100']",31,19,12,0.6129032258064516,0.3870967741935484,7,4,0.9629004147713268,0
"['0', '110110', '0101111']",14,9,5,0.6428571428571429,0.3571428571428571,4,1,0.9402859586706313,1
['010001'],6,2,4,0.3333333333333333,0.6666666666666666,0,1,0.9182958340544896,1
"['00001', '1111101', '0', '110', '000000', '1111']",26,13,13,0.5,0.5,6,5,1.0,0
"['10100', '001011', '0101101', '11011', '1010111', '0', '011001', '00', '111']",42,24,18,0.5714285714285714,0.4285714285714285,7,5,0.9852281360342516,0
"['00001', '1']",6,2,4,0.3333333333333333,0.6666666666666666,1,2,0.9182958340544896,1
"['110000', '111', '0101', '1', '001', '111', '01111', '001']",28,17,11,0.6071428571428571,0.3928571428571428,7,4,0.9666186325481028,0
"['01', '0100001', '0100010', '001000', '1', '1', '101011', '1010111', '10011']",42,20,22,0.4761904761904761,0.5238095238095238,5,6,0.998363672593813,0
"['11001', '1000', '001', '1', '00100', '0111101', '1001', '0001110']",36,17,19,0.4722222222222222,0.5277777777777778,7,7,0.997772472089982,0
"['011110', '000', '1', '10010', '1100']",19,9,10,0.4736842105263157,0.5263157894736842,4,4,0.9980008838722996,1
"['101010', '01110', '1000']",15,7,8,0.4666666666666667,0.5333333333333333,1,2,0.9967916319816366,1
"['01', '00000', '00001', '11', '001', '1', '101', '0001011']",28,11,17,0.3928571428571428,0.6071428571428571,3,6,0.9666186325481028,0
"['101101', '001000', '00000', '00101', '010', '1100000', '000', '01', '001', '0']",41,12,29,0.2926829268292683,0.7073170731707317,2,11,0.8721617883411701,0
"['100', '0011']",7,3,4,0.4285714285714285,0.5714285714285714,1,2,0.9852281360342516,1
"['10', '000', '001001', '0010', '0']",16,4,12,0.25,0.75,0,6,0.8112781244591328,0
"['1011100', '1', '10', '10', '001', '0010000']",22,9,13,0.4090909090909091,0.5909090909090909,2,5,0.9760206482366148,0
"['1010', '1110', '001011', '0101000', '11', '111', '0', '0', '1111', '0010000']",39,20,19,0.5128205128205128,0.4871794871794871,6,6,0.999525689293649,0
"['1100', '11', '010', '0', '110100', '0']",17,8,9,0.4705882352941176,0.5294117647058824,3,3,0.9975025463691152,0
"['1101001', '011', '1010100', '1110', '11', '111', '1', '00']",29,18,11,0.6206896551724138,0.3793103448275862,6,3,0.9575534837147482,0
"['010000', '0111110', '100', '0111110', '1', '1111011', '1001', '101101', '00000', '01000']",51,26,25,0.5098039215686274,0.4901960784313725,9,8,0.9997226475394072,0
['11000'],5,2,3,0.4,0.6,1,1,0.9709505944546686,1
"['0011', '11100', '110101', '1001', '0111010', '00', '0011']",32,17,15,0.53125,0.46875,6,5,0.9971803988942642,1
"['01', '0110101']",9,5,4,0.5555555555555556,0.4444444444444444,1,0,0.9910760598382222,1
"['011011', '001111', '0', '0110', '0110010', '0001001', '1000001', '110']",41,19,22,0.4634146341463415,0.5365853658536586,8,9,0.9961344835095796,0
['01'],2,1,1,0.5,0.5,0,0,1.0,1
"['11', '00', '001', '00', '11010', '001', '1', '0100', '1110011', '110']",32,16,16,0.5,0.5,6,6,1.0,0
"['10111', '10', '1', '01001', '0100', '0111101', '00110', '11111', '1']",35,22,13,0.6285714285714286,0.3714285714285714,8,3,0.9517626756348312,0
"['0100110', '00010', '00001', '0100100', '11111', '11']",31,14,17,0.4516129032258064,0.5483870967741935,4,7,0.9932338197397066,0
"['100000', '10000', '11011', '000101', '10000', '10001']",32,11,21,0.34375,0.65625,3,8,0.9283620723948676,1
['100'],3,1,2,0.3333333333333333,0.6666666666666666,0,1,0.9182958340544896,1
['1011'],4,3,1,0.75,0.25,1,0,0.8112781244591328,1
"['1101', '0', '11001', '1', '0111010', '0000', '00', '11', '0001', '10']",32,15,17,0.46875,0.53125,6,5,0.9971803988942642,0
"['100011', '11', '1', '1010', '0', '110', '111001', '0101000', '100110']",36,19,17,0.5277777777777778,0.4722222222222222,6,5,0.997772472089982,0
"['111101', '1000011', '1', '1111011', '1111', '1', '1', '0101110']",34,25,9,0.7352941176470589,0.2647058823529412,11,2,0.833764907210665,0
"['110', '0', '0', '1', '1110000', '001']",16,7,9,0.4375,0.5625,3,4,0.9886994082884974,0
['1000011'],7,3,4,0.4285714285714285,0.5714285714285714,1,2,0.9852281360342516,1
"['00', '10', '11', '011100', '11011', '0110', '000', '1011']",28,15,13,0.5357142857142857,0.4642857142857143,6,4,0.996316519558962,0
"['1010', '01111', '010', '01110', '1', '001110', '10101']",29,17,12,0.5862068965517241,0.4137931034482758,4,3,0.9784493292686188,0
"['0011', '00', '1', '00001', '1011001', '11', '0011', '0011101', '0110', '10010']",41,20,21,0.4878048780487805,0.5121951219512195,7,8,0.9995708393473224,0
"['1000', '11011', '11001', '011001', '10100']",25,13,12,0.52,0.48,5,4,0.9988455359952018,1
"['1001100', '100101', '1010101', '10110', '0111']",29,16,13,0.5517241379310345,0.4482758620689655,5,4,0.9922666387194964,1
"['111', '0', '000000', '10']",12,4,8,0.3333333333333333,0.6666666666666666,1,3,0.9182958340544896,0
['1010'],4,2,2,0.5,0.5,0,0,1.0,1
"['10', '10010', '1111111', '0', '1010', '10011', '00', '111', '00']",31,18,13,0.5806451612903226,0.4193548387096774,5,4,0.9811522341999132,0
"['01101', '1101101', '11001', '0010110', '1100', '0', '1110', '101']",36,21,15,0.5833333333333334,0.4166666666666667,7,3,0.9798687566511528,0
"['111', '0111', '100001']",13,8,5,0.6153846153846154,0.3846153846153846,3,2,0.961236604722876,1
"['11101', '111111', '11', '0000110', '0001', '00']",26,15,11,0.5769230769230769,0.4230769230769231,6,5,0.9828586897127056,0
"['1101', '00110', '011111', '101101', '00000', '0001111']",33,18,15,0.5454545454545454,0.4545454545454545,8,6,0.9940302114769564,1
"['1001000', '100', '10010', '00', '0', '110', '0001100', '10110']",33,12,21,0.3636363636363636,0.6363636363636364,3,9,0.94566030460064,0
['101001'],6,3,3,0.5,0.5,0,1,1.0,1
"['11011', '010']",8,5,3,0.625,0.375,2,0,0.954434002924965,1
['11'],2,2,0,1.0,0.0,1,0,-0.0,1
"['001000', '0010']",10,2,8,0.2,0.8,0,3,0.7219280948873623,1
"['1100101', '01', '1000', '1111010', '001111', '110010', '1001', '01']",38,21,17,0.5526315789473685,0.4473684210526316,7,5,0.9919924034538556,0
"['111110', '1000', '00100', '011', '1000010', '100101']",31,14,17,0.4516129032258064,0.5483870967741935,3,6,0.9932338197397066,1
['1110010'],7,4,3,0.5714285714285714,0.4285714285714285,1,1,0.9852281360342516,1
"['10', '11110', '0111111', '10111', '1', '11', '001111', '1111111', '0001100', '011011']",48,35,13,0.7291666666666666,0.2708333333333333,16,4,0.8426578772022391,0
"['0001111', '11', '0010']",13,7,6,0.5384615384615384,0.4615384615384615,3,2,0.9957274520849256,1
"['010', '0', '1110', '101', '00100', '1011', '00101', '1011100', '101111']",38,21,17,0.5526315789473685,0.4473684210526316,6,5,0.9919924034538556,0
['0001001'],7,2,5,0.2857142857142857,0.7142857142857143,0,2,0.863120568566631,1
"['0', '1001110', '1110', '0101110', '100', '100001', '0010', '110', '000']",38,17,21,0.4473684210526316,0.5526315789473685,4,8,0.9919924034538556,0
"['001', '111001', '001', '0011011', '001', '1001', '0110', '0000100']",37,16,21,0.4324324324324324,0.5675675675675675,6,9,0.9867867202680318,1
"['10011', '011001', '1001011']",18,10,8,0.5555555555555556,0.4444444444444444,4,3,0.9910760598382222,1
"['1010100', '100', '0', '100111', '000100', '1101101']",30,14,16,0.4666666666666667,0.5333333333333333,3,5,0.9967916319816366,0
"['11011', '0111111']",12,10,2,0.8333333333333334,0.1666666666666666,5,0,0.6500224216483541,1
"['110100', '0110000']",13,5,8,0.3846153846153846,0.6153846153846154,2,3,0.961236604722876,1
"['0', '0000000', '1000', '1100', '00', '010000', '0011011']",31,8,23,0.2580645161290322,0.7419354838709677,3,10,0.8238116333123173,0
"['0100', '1', '1', '10', '001001', '1', '0', '10001', '010', '01001']",29,12,17,0.4137931034482758,0.5862068965517241,2,6,0.9784493292686188,0
"['1000000', '1011', '100']",14,5,9,0.3571428571428571,0.6428571428571429,1,4,0.9402859586706313,1
['01100'],5,2,3,0.4,0.6,1,1,0.9709505944546686,1
"['1', '0110', '1000', '11', '011', '001', '0001111', '0100', '10', '11011']",35,19,16,0.5428571428571428,0.4571428571428571,7,4,0.9946937953613058,0
"['111101', '0', '1111111', '11010', '1000010']",26,17,9,0.6538461538461539,0.3461538461538461,6,2,0.9305861291319928,1
"['00', '1', '0111101', '110', '011']",16,10,6,0.625,0.375,4,2,0.954434002924965,0
"['00001', '010', '1', '1', '00000']",15,4,11,0.2666666666666666,0.7333333333333333,1,4,0.8366407419411672,1
"['10010', '01']",7,3,4,0.4285714285714285,0.5714285714285714,0,2,0.9852281360342516,1
['1111'],4,4,0,1.0,0.0,2,0,-0.0,1
"['0', '1', '11010', '01010', '11010', '100', '010', '11011', '0011011']",35,19,16,0.5428571428571428,0.4571428571428571,6,3,0.9946937953613058,0
"['1001', '10011', '010110', '0110001']",22,11,11,0.5,0.5,4,4,1.0,1
"['011100', '01100', '010', '0110110', '011000', '0110']",31,14,17,0.4516129032258064,0.5483870967741935,6,6,0.9932338197397066,1
"['10', '0', '0110010', '01101', '101']",18,9,9,0.5,0.5,3,3,1.0,0
"['11011', '11', '01', '0110', '11']",15,11,4,0.7333333333333333,0.2666666666666666,5,0,0.8366407419411672,0
"['011100', '1', '001', '1010000', '1001']",21,9,12,0.4285714285714285,0.5714285714285714,2,5,0.9852281360342516,0
"['110', '0011010', '11111', '11', '01', '00111', '10101', '110']",32,21,11,0.65625,0.34375,8,2,0.9283620723948676,0
['1'],1,1,0,1.0,0.0,0,0,-0.0,1
"['101', '1', '0', '0']",6,3,3,0.5,0.5,1,1,1.0,0
"['110', '111', '0011', '001']",13,8,5,0.6153846153846154,0.3846153846153846,3,2,0.961236604722876,1
"['011', '1001', '111', '010', '0000', '1011']",21,11,10,0.5238095238095238,0.4761904761904761,4,3,0.998363672593813,1
"['1', '1111', '00011', '10', '0', '111101']",19,13,6,0.6842105263157895,0.3157894736842105,5,2,0.8997437586982626,0
"['01111', '1', '0101101', '111110', '111', '11111']",27,22,5,0.8148148148148148,0.1851851851851851,10,0,0.691289869405789,0
"['11001', '01111', '110100', '01', '0111', '00', '0000010']",31,15,16,0.4838709677419355,0.5161290322580645,5,5,0.9992492479956564,0
"['1', '01', '000101', '1110']",13,7,6,0.5384615384615384,0.4615384615384615,2,1,0.9957274520849256,0
"['1', '11100', '111']",9,7,2,0.7777777777777778,0.2222222222222222,3,1,0.7642045065086203,0
"['00', '01', '01', '1101', '0100001', '10100', '0', '000', '01110', '0011']",35,14,21,0.4,0.6,4,7,0.9709505944546686,0
"['100', '0', '00', '10011', '010111', '1011110', '110', '10', '00000']",34,16,18,0.4705882352941176,0.5294117647058824,6,6,0.9975025463691152,0
"['1001', '1001111', '1110', '00', '0', '001', '1', '1']",23,13,10,0.5652173913043478,0.4347826086956521,5,5,0.9876925088958034,0
"['10', '11110', '010010']",13,7,6,0.5384615384615384,0.4615384615384615,2,2,0.9957274520849256,1
"['00', '0111011', '1', '0', '11', '0001', '000110']",23,11,12,0.4782608695652174,0.5217391304347826,4,3,0.9986359641585718,0
"['00101', '0', '1101101']",13,7,6,0.5384615384615384,0.4615384615384615,2,1,0.9957274520849256,1
"['01010', '0', '101', '001', '0111000', '010', '0', '00000', '11', '1']",31,12,19,0.3870967741935484,0.6129032258064516,2,7,0.9629004147713268,0
"['0', '1110', '0', '11', '1', '1011101', '1', '01101', '000110', '110100']",34,20,14,0.5882352941176471,0.4117647058823529,8,3,0.9774178175281716,0
"['00', '01']",4,1,3,0.25,0.75,0,1,0.8112781244591328,1
"['01', '11010', '00010', '1111', '1', '00011', '0110', '1010010', '01001', '10010']",43,21,22,0.4883720930232558,0.5116279069767442,6,7,0.999609836367807,0
"['01', '011', '1010', '0', '11001', '01100', '000', '1100010']",30,13,17,0.4333333333333333,0.5666666666666667,4,5,0.9871377743721864,0
"['100001', '0', '0100110', '0100010', '111111', '1111', '110010', '10010']",42,22,20,0.5238095238095238,0.4761904761904761,7,8,0.998363672593813,0
"['0010', '0110', '11', '010000', '000011', '1101', '1', '0001', '0000', '01101']",40,16,24,0.4,0.6,6,9,0.9709505944546686,0
"['010101', '00', '01111', '1']",14,8,6,0.5714285714285714,0.4285714285714285,2,1,0.9852281360342516,1
"['1', '0001', '1', '10', '01', '11001', '11100']",20,11,9,0.55,0.45,4,4,0.9927744539878084,0
"['000000', '00010', '110001', '1100']",21,6,15,0.2857142857142857,0.7142857142857143,2,6,0.863120568566631,1
"['0', '111011', '1010', '11001', '01110', '010101', '01011', '10', '0001', '1010']",42,23,19,0.5476190476190477,0.4523809523809524,6,4,0.9934472383802028,0
"['001', '1110', '100', '1100', '011', '11110', '0']",23,13,10,0.5652173913043478,0.4347826086956521,6,4,0.9876925088958034,0
"['0011101', '0011', '1', '011', '01', '111', '11']",22,15,7,0.6818181818181818,0.3181818181818182,6,2,0.9023932827949788,0
"['00101', '110', '101010', '000', '0000010', '0011010', '1001', '11110']",40,17,23,0.425,0.575,4,7,0.983708262623186,1
"['1', '010101', '001000', '101101', '00', '101000', '1001', '11100', '1000', '00']",42,17,25,0.4047619047619047,0.5952380952380952,3,8,0.97366806454962,0
"['100011', '11']",8,5,3,0.625,0.375,2,1,0.954434002924965,1
"['10010', '1000', '1']",10,4,6,0.4,0.6,0,2,0.9709505944546686,1
"['11', '1100', '10', '10100', '1001111', '010111']",26,16,10,0.6153846153846154,0.3846153846153846,5,3,0.961236604722876,0
"['100', '1', '1001111', '00', '0', '1001', '010010', '01101', '1', '1']",31,16,15,0.5161290322580645,0.4838709677419355,5,6,0.9992492479956564,0
"['010', '111', '0']",7,4,3,0.5714285714285714,0.4285714285714285,1,0,0.9852281360342516,1
"['011011', '01', '010000', '01', '0011', '101101']",26,13,13,0.5,0.5,4,3,1.0,0
['1100'],4,2,2,0.5,0.5,1,1,1.0,1
"['11011', '1011', '101', '1', '11010', '00']",20,13,7,0.65,0.35,5,1,0.934068055375491,0
['111111'],6,6,0,1.0,0.0,3,0,-0.0,1
"['00', '0100100', '1000', '0001']",17,4,13,0.2352941176470588,0.7647058823529411,0,6,0.7871265862012691,1
"['0011101', '1001101', '1001', '0']",19,10,9,0.5263157894736842,0.4736842105263157,4,3,0.9980008838722996,1
"['1000', '011000']",10,3,7,0.3,0.7,1,3,0.8812908992306927,1
"['111', '10000', '0011011', '1110', '011100']",25,14,11,0.56,0.44,6,5,0.9895875212220556,1
"['1010', '101', '1011100', '0001100', '101010', '011', '0010', '101', '101000', '1100000']",50,22,28,0.44,0.56,6,8,0.9895875212220556,0
"['0010111', '010', '1000', '1111100', '1001', '10', '1010101']",34,18,16,0.5294117647058824,0.4705882352941176,4,4,0.9975025463691152,0
"['0', '011101', '1111110', '100', '011', '101100', '101', '10', '111', '000']",37,22,15,0.5945945945945946,0.4054054054054054,8,4,0.974024864435752,0
"['01', '101', '1', '00110', '1']",12,7,5,0.5833333333333334,0.4166666666666667,3,1,0.9798687566511528,0
"['11', '101010', '0', '0', '1', '1101010', '01001', '001', '00100']",31,14,17,0.4516129032258064,0.5483870967741935,2,6,0.9932338197397066,0
"['000', '0111000', '001101', '100', '110000', '11', '01110', '1111', '11101', '0010110']",48,25,23,0.5208333333333334,0.4791666666666667,10,8,0.9987472979361685,0
"['000', '10', '100', '11101', '0']",14,6,8,0.4285714285714285,0.5714285714285714,1,2,0.9852281360342516,0
"['01', '0011', '10100']",11,5,6,0.4545454545454545,0.5454545454545454,1,2,0.9940302114769564,1
"['1101001', '10100', '101111', '01010', '000101', '0010001', '0', '10']",39,18,21,0.4615384615384615,0.5384615384615384,4,6,0.9957274520849256,0
"['11111', '0']",6,5,1,0.8333333333333334,0.1666666666666666,2,0,0.6500224216483541,1
"['11000', '1', '0011000', '1', '01', '1', '11000', '0', '11100', '0000010']",35,14,21,0.4,0.6,5,8,0.9709505944546686,0
"['1101', '1011']",8,6,2,0.75,0.25,3,0,0.8112781244591328,1
"['0', '0101', '00', '001', '1101', '10010', '11101', '101111']",30,17,13,0.5666666666666667,0.4333333333333333,6,4,0.9871377743721864,0
"['010011', '10100', '0010', '1111010', '1', '1', '10', '011011', '011']",35,20,15,0.5714285714285714,0.4285714285714285,7,4,0.9852281360342516,0
['000100'],6,1,5,0.1666666666666666,0.8333333333333334,0,2,0.6500224216483541,1
"['11010', '111', '010100', '1111', '10101', '101', '1', '11', '0']",30,20,10,0.6666666666666666,0.3333333333333333,7,1,0.9182958340544896,0
"['111', '0011', '1101110']",14,10,4,0.7142857142857143,0.2857142857142857,4,1,0.863120568566631,1
"['0010000', '10111', '100', '1001100', '1000', '1011', '000111', '11100']",41,19,22,0.4634146341463415,0.5365853658536586,7,9,0.9961344835095796,1
"['1101100', '1100001', '1011100', '1', '01', '111110', '00', '01111']",37,22,15,0.5945945945945946,0.4054054054054054,10,6,0.974024864435752,0
"['0', '11', '111000', '0001110', '0', '1']",18,9,9,0.5,0.5,3,4,1.0,0
"['10101', '010100']",11,5,6,0.4545454545454545,0.5454545454545454,0,1,0.9940302114769564,1
"['001', '011000', '01010', '101100', '11010', '011', '1101010']",35,17,18,0.4857142857142857,0.5142857142857142,5,5,0.9994110647387552,1
"['1001100', '00010', '101', '0111', '111000']",25,12,13,0.48,0.52,4,4,0.9988455359952018,1
"['1100100', '10', '01', '0100']",15,6,9,0.4,0.6,1,4,0.9709505944546686,1
"['0100000', '1101101', '1000', '100', '0', '100', '00', '010111', '000111']",39,16,23,0.4102564102564102,0.5897435897435898,5,7,0.97663491144401,0
"['000000', '10100', '101', '10', '101111', '0', '000101']",29,12,17,0.4137931034482758,0.5862068965517241,3,6,0.9784493292686188,0
"['10000', '01', '01101', '1100000', '1010', '1011011', '000', '11111', '00', '0110']",44,21,23,0.4772727272727273,0.5227272727272727,7,6,0.9985090989176322,0
"['0', '101', '101111', '0', '0100']",15,8,7,0.5333333333333333,0.4666666666666667,3,2,0.9967916319816366,1
"['10', '100', '1110001', '101', '101101', '1', '0011101', '001111']",35,21,14,0.6,0.4,8,4,0.9709505944546686,0
"['1', '0', '10111', '0', '110111', '0', '101', '10000', '0100111', '110100']",36,20,16,0.5555555555555556,0.4444444444444444,6,4,0.9910760598382222,0
"['11', '00', '0010110']",11,5,6,0.4545454545454545,0.5454545454545454,2,2,0.9940302114769564,1
"['0001', '0101', '1110', '0110001', '01', '000000']",27,10,17,0.3703703703703703,0.6296296296296297,3,6,0.9509560484549724,0
"['101101', '101011', '00', '1', '1000100']",22,11,11,0.5,0.5,4,3,1.0,1
['00101'],5,2,3,0.4,0.6,0,1,0.9709505944546686,1
"['00', '01110']",7,3,4,0.4285714285714285,0.5714285714285714,1,1,0.9852281360342516,1
"['001', '1001011']",10,5,5,0.5,0.5,2,2,1.0,1
"['10010', '11']",7,4,3,0.5714285714285714,0.4285714285714285,1,1,0.9852281360342516,1
"['01', '01100', '10010', '010001']",18,7,11,0.3888888888888889,0.6111111111111112,1,4,0.964078764808229,1
"['1111010', '110', '10110', '0101111', '00', '1']",25,16,9,0.64,0.36,6,2,0.9426831892554922,0
"['110101', '1001']",10,6,4,0.6,0.4,2,1,0.9709505944546686,1
"['11', '0100', '10100']",11,5,6,0.4545454545454545,0.5454545454545454,1,2,0.9940302114769564,1
"['10', '1', '1100']",7,4,3,0.5714285714285714,0.4285714285714285,1,1,0.9852281360342516,1
"['010', '0', '001', '011', '10', '101', '000011']",21,9,12,0.4285714285714285,0.5714285714285714,2,4,0.9852281360342516,0
"['1111', '1', '1011111', '011', '010011', '010', '000100', '0010']",34,19,15,0.5588235294117647,0.4411764705882353,7,5,0.9899927915575186,0
"['000', '1']",4,1,3,0.25,0.75,0,1,0.8112781244591328,1
"['010000', '11', '00001', '10011', '1001110']",25,11,14,0.44,0.56,4,6,0.9895875212220556,1
"['10111', '101000', '0001']",15,7,8,0.4666666666666667,0.5333333333333333,2,3,0.9967916319816366,1
"['010000', '1001', '0', '1110', '11101']",20,10,10,0.5,0.5,2,3,1.0,0
"['11010', '00010', '1110', '1000001', '10', '1100110', '1011011', '0100101', '110101']",50,26,24,0.52,0.48,8,6,0.9988455359952018,0
"['101111', '1', '1000101', '1001']",18,11,7,0.6111111111111112,0.3888888888888889,4,2,0.964078764808229,1
"['10010', '1000101', '0010', '10', '1111', '01', '000']",27,12,15,0.4444444444444444,0.5555555555555556,2,4,0.9910760598382222,0
"['101', '0100010', '0110', '11111']",19,11,8,0.5789473684210527,0.4210526315789473,3,2,0.9819407868640976,1
"['001110', '11001', '0100', '110', '11', '0', '00111']",26,14,12,0.5384615384615384,0.4615384615384615,5,4,0.9957274520849256,0
"['010111', '1100100', '11', '01']",17,10,7,0.5882352941176471,0.4117647058823529,3,2,0.9774178175281716,0
"['0', '1010']",5,2,3,0.4,0.6,0,0,0.9709505944546686,1
"['11100', '01', '0000100', '0100', '0010110', '1', '110011']",32,14,18,0.4375,0.5625,4,7,0.9886994082884974,0
"['10', '10', '1111', '10010']",13,8,5,0.6153846153846154,0.3846153846153846,2,1,0.961236604722876,1
"['111110', '1000', '1111', '11111', '0111']",23,18,5,0.782608695652174,0.217391304347826,7,1,0.7553754125614287,0
"['0', '1101100', '10', '10', '0000000', '0', '00', '01111']",27,10,17,0.3703703703703703,0.6296296296296297,4,7,0.9509560484549724,0
"['011', '0000', '0011100', '01011', '00', '001000']",27,9,18,0.3333333333333333,0.6666666666666666,3,7,0.9182958340544896,0
"['01011', '11101', '0101', '0100', '0', '110', '000011', '11', '0100', '1010']",38,19,19,0.5,0.5,5,4,1.0,0
"['010', '10', '11001', '0011010', '111101']",23,13,10,0.5652173913043478,0.4347826086956521,4,2,0.9876925088958034,1
"['110111', '0', '010', '01', '1']",13,8,5,0.6153846153846154,0.3846153846153846,3,2,0.961236604722876,0
"['0', '001101', '0', '010001', '011101', '0']",21,9,12,0.4285714285714285,0.5714285714285714,2,3,0.9852281360342516,1
"['110', '00', '1011', '0101', '01', '1000010', '1', '1100', '11101', '01']",34,18,16,0.5294117647058824,0.4705882352941176,5,4,0.9975025463691152,0
['110'],3,2,1,0.6666666666666666,0.3333333333333333,1,0,0.9182958340544896,1
"['1', '0110']",5,3,2,0.6,0.4,1,0,0.9709505944546686,1
"['101011', '1010']",10,6,4,0.6,0.4,1,0,0.9709505944546686,1
"['111000', '0000000']",13,3,10,0.2307692307692307,0.7692307692307693,1,5,0.7793498372920851,1
"['00011', '0100001', '11', '1001001', '001111', '1011', '1', '01111', '0100011', '1']",45,25,20,0.5555555555555556,0.4444444444444444,9,7,0.9910760598382222,0
"['0010110', '00', '100', '000001', '0', '1', '101', '0101110', '000111']",36,15,21,0.4166666666666667,0.5833333333333334,4,7,0.9798687566511528,0
"['1100', '10', '01', '0000']",12,4,8,0.3333333333333333,0.6666666666666666,1,4,0.9182958340544896,1
"['01011', '110010', '11010', '0101010']",23,12,11,0.5217391304347826,0.4782608695652174,3,2,0.9986359641585718,1
"['00', '1', '001', '01000', '01', '011', '1', '111']",20,10,10,0.5,0.5,3,4,1.0,0
"['0', '0011', '1111010', '000', '1100', '00', '0011', '10001']",30,13,17,0.4333333333333333,0.5666666666666667,5,7,0.9871377743721864,0
"['00100', '011', '1010', '100']",15,6,9,0.4,0.6,1,3,0.9709505944546686,1
"['011000', '111', '0', '1', '111', '10', '1011011', '110110', '10']",31,20,11,0.6451612903225806,0.3548387096774194,8,1,0.9383153522334068,0
"['01011', '10100', '0100', '1', '0', '0000101', '0010010', '10110']",35,14,21,0.4,0.6,2,6,0.9709505944546686,0
"['111001', '000011', '01101', '1', '1010']",22,12,10,0.5454545454545454,0.4545454545454545,4,3,0.9940302114769564,1
"['00001', '101001', '111', '0', '0000101', '11001', '1000', '000']",34,13,21,0.3823529411764705,0.6176470588235294,5,9,0.9596868937742168,0
"['0011101', '010111', '000', '001', '011']",22,11,11,0.5,0.5,3,3,1.0,1
"['0', '1111', '1011011']",12,9,3,0.75,0.25,4,0,0.8112781244591328,1
"['1', '00', '011', '010', '11', '101']",14,8,6,0.5714285714285714,0.4285714285714285,2,1,0.9852281360342516,0
['1101001'],7,4,3,0.5714285714285714,0.4285714285714285,1,1,0.9852281360342516,1
"['1', '111000', '111', '1', '101100', '1', '10111', '100']",26,17,9,0.6538461538461539,0.3461538461538461,8,3,0.9305861291319928,0
"['11', '1011111', '1', '0']",11,9,2,0.8181818181818182,0.1818181818181818,4,0,0.6840384356390417,0
"['1111011', '111101']",13,11,2,0.8461538461538461,0.1538461538461538,5,0,0.6193821946787638,1
"['0', '0010', '11001', '1', '100', '1010', '00', '100', '100']",26,10,16,0.3846153846153846,0.6153846153846154,2,6,0.961236604722876,0
"['0100110', '0011001', '1011', '10', '10100', '1101001', '01001', '11111', '011100', '1011']",52,29,23,0.5576923076923077,0.4423076923076923,10,7,0.990374836448575,0
"['00100', '00']",7,1,6,0.1428571428571428,0.8571428571428571,0,3,0.5916727785823275,1
"['0100', '0011101', '101', '0000100', '0110110']",28,12,16,0.4285714285714285,0.5714285714285714,4,5,0.9852281360342516,1
"['010', '00100', '0', '0011000', '0011', '011', '101011', '000', '111']",35,15,20,0.4285714285714285,0.5714285714285714,5,6,0.9852281360342516,0
"['00', '0', '1111110']",10,6,4,0.6,0.4,3,1,0.9709505944546686,0
"['00', '11101', '01', '001101']",15,8,7,0.5333333333333333,0.4666666666666667,2,2,0.9967916319816366,1
"['00', '011000', '111011']",14,7,7,0.5,0.5,3,2,1.0,1
"['110', '011', '11', '11', '101011']",16,12,4,0.75,0.25,5,1,0.8112781244591328,0
"['00101', '11110', '01', '101', '01001', '00']",22,11,11,0.5,0.5,3,4,1.0,0
"['101', '101001', '10', '001', '1111']",18,11,7,0.6111111111111112,0.3888888888888889,4,2,0.964078764808229,0
"['100', '0111', '1', '10111', '010010', '11101', '1110', '001000', '1011']",38,22,16,0.5789473684210527,0.4210526315789473,7,4,0.9819407868640976,0
"['010001', '001011', '10101', '1', '101', '110', '100001']",30,15,15,0.5,0.5,3,4,1.0,0
"['001111', '0', '01100']",12,6,6,0.5,0.5,3,3,1.0,1
"['10000', '1101001', '1101011', '01']",21,11,10,0.5238095238095238,0.4761904761904761,3,3,0.998363672593813,1
"['01011', '001', '0', '1', '11', '0', '10111', '1001101']",25,15,10,0.6,0.4,5,2,0.9709505944546686,0
"['01111', '011101', '1', '11111', '0101100']",24,17,7,0.7083333333333334,0.2916666666666667,7,1,0.8708644692353644,0
['1'],1,1,0,1.0,0.0,0,0,-0.0,1
"['100001', '100011', '01110', '100', '11', '1', '1010001', '0100111', '001', '0000']",44,20,24,0.4545454545454545,0.5454545454545454,6,9,0.9940302114769564,0
"['001', '00110', '000', '1', '01100', '10101', '101']",25,11,14,0.44,0.56,3,5,0.9895875212220556,0
"['01111', '11101', '0000000']",17,8,9,0.4705882352941176,0.5294117647058824,3,3,0.9975025463691152,1
"['1', '111', '0', '101100', '01', '10']",15,9,6,0.6,0.4,4,1,0.9709505944546686,0
"['111101', '0100', '01001', '1001001', '1011', '1', '1']",28,16,12,0.5714285714285714,0.4285714285714285,6,4,0.9852281360342516,0
"['10', '00', '11', '1']",7,4,3,0.5714285714285714,0.4285714285714285,1,1,0.9852281360342516,0
"['110', '011000', '00110', '1001000', '01', '000111', '100011', '111', '00011', '101001']",49,23,26,0.4693877551020408,0.5306122448979592,8,10,0.9972943816462349,0
"['01', '11', '1', '1', '111', '01', '0010', '101101']",21,14,7,0.6666666666666666,0.3333333333333333,5,1,0.9182958340544896,0
"['1', '01000', '1011', '010111', '010']",19,10,9,0.5263157894736842,0.4736842105263157,2,1,0.9980008838722996,0
"['1111000', '100000']",13,5,8,0.3846153846153846,0.6153846153846154,2,3,0.961236604722876,1
"['011', '1001010', '001', '01001']",18,8,10,0.4444444444444444,0.5555555555555556,1,3,0.9910760598382222,1
"['0010010', '01111', '1011111', '11101', '11', '1100', '101010', '10', '00100', '11']",45,27,18,0.6,0.4,9,6,0.9709505944546686,0
"['110', '111101']",9,7,2,0.7777777777777778,0.2222222222222222,3,0,0.7642045065086203,1
"['0110100', '100', '0000100']",17,5,12,0.2941176470588235,0.7058823529411765,1,5,0.8739810481273578,1
"['10011', '0011001', '0100', '11', '1100', '0101', '1010011', '1101', '010010']",43,22,21,0.5116279069767442,0.4883720930232558,7,7,0.999609836367807,0
"['0001', '1011001', '00', '1110101']",20,10,10,0.5,0.5,3,3,1.0,1
['1000'],4,1,3,0.25,0.75,0,1,0.8112781244591328,1
['11'],2,2,0,1.0,0.0,1,0,-0.0,1
['0101'],4,2,2,0.5,0.5,0,0,1.0,1
"['111111', '0110', '0']",11,8,3,0.7272727272727273,0.2727272727272727,4,1,0.8453509366224364,1
"['00101', '10']",7,3,4,0.4285714285714285,0.5714285714285714,1,1,0.9852281360342516,1
"['0', '1', '011', '10', '00', '1', '0011', '0', '1100', '001100']",25,11,14,0.44,0.56,4,5,0.9895875212220556,0
"['0001111', '100001', '000', '0110', '1011000', '101', '0001010', '110', '0', '10']",43,18,25,0.4186046511627907,0.5813953488372093,5,8,0.9807983646944296,0
"['011101', '1110', '11000', '11', '0111100', '010010', '1', '01', '000', '010110']",42,22,20,0.5238095238095238,0.4761904761904761,8,5,0.998363672593813,0
"['0011110', '1101101', '1111', '0111001', '10', '1', '0011', '0', '10']",35,22,13,0.6285714285714286,0.3714285714285714,9,3,0.9517626756348312,0
"['1', '1', '111000', '010', '0111', '0', '0111110', '1100111', '101000', '101']",39,23,16,0.5897435897435898,0.4102564102564102,8,6,0.97663491144401,0
"['01', '01', '0']",5,2,3,0.4,0.6,0,0,0.9709505944546686,1
"['10', '1', '0001011', '1101011', '1011', '10']",23,14,9,0.6086956521739131,0.391304347826087,4,1,0.9656361333706098,0
"['0010110', '010']",10,4,6,0.4,0.6,1,2,0.9709505944546686,1
"['11', '101', '1010', '1100', '0', '110', '11101', '00001']",27,15,12,0.5555555555555556,0.4444444444444444,5,3,0.9910760598382222,0
"['111011', '1110101']",13,10,3,0.7692307692307693,0.2307692307692307,3,0,0.7793498372920851,1
"['01111', '01', '100001', '1', '111100', '0110011']",27,16,11,0.5925925925925926,0.4074074074074074,8,4,0.975119064940866,0
"['011', '01', '11101', '01001', '0001000', '000100', '0000', '0000', '001', '1111000']",46,16,30,0.3478260869565217,0.6521739130434783,5,12,0.9321115676166748,0
"['1111010', '0001', '011', '1', '1', '11', '11000', '11']",25,16,9,0.64,0.36,7,3,0.9426831892554922,0
"['011', '01001', '0011', '00', '01101', '00000', '0110000', '111100', '000000']",43,15,28,0.3488372093023256,0.6511627906976745,6,12,0.9330252953592912,0
"['1110101', '0']",8,5,3,0.625,0.375,1,0,0.954434002924965,1
"['0', '101', '1101011', '0111', '1110010', '1100', '01010', '000', '010001']",40,20,20,0.5,0.5,6,5,1.0,0
"['01010', '1100', '11', '1000101', '001', '1011', '01', '10', '010010']",35,17,18,0.4857142857142857,0.5142857142857142,5,5,0.9994110647387552,0
"['10000', '01', '0001101', '0']",15,5,10,0.3333333333333333,0.6666666666666666,1,3,0.9182958340544896,0
"['00', '00111']",7,3,4,0.4285714285714285,0.5714285714285714,1,2,0.9852281360342516,1
"['110', '0110110']",10,6,4,0.6,0.4,3,1,0.9709505944546686,1
"['1', '1000100', '101']",11,5,6,0.4545454545454545,0.5454545454545454,1,2,0.9940302114769564,1
"['11', '10']",4,3,1,0.75,0.25,1,0,0.8112781244591328,1
"['110010', '0001', '1', '011010', '1100', '1011000', '10', '1', '1010000']",38,17,21,0.4473684210526316,0.5526315789473685,6,7,0.9919924034538556,0
"['1', '01111', '0101000', '10110', '0100', '1', '000']",26,12,14,0.4615384615384615,0.5384615384615384,3,4,0.9957274520849256,1
"['1000', '1', '1110000', '0', '0011', '0111', '0', '1110']",26,13,13,0.5,0.5,5,4,1.0,0
"['011100', '1010', '11', '0', '1100', '010000']",23,10,13,0.4347826086956521,0.5652173913043478,3,4,0.9876925088958034,0
['000'],3,0,3,0.0,1.0,0,1,-0.0,1
"['10', '1111', '1000000', '0110', '01010', '0100', '00101', '0', '0', '01']",35,14,21,0.4,0.6,3,8,0.9709505944546686,0
"['1', '001', '00111', '11011', '1']",15,10,5,0.6666666666666666,0.3333333333333333,3,2,0.9182958340544896,0
"['11', '111100', '1010010', '00111', '011110', '1010101', '00100']",38,21,17,0.5526315789473685,0.4473684210526316,6,5,0.9919924034538556,1
"['1011', '0', '10100']",10,5,5,0.5,0.5,1,1,1.0,1
"['0001101', '011000']",13,5,8,0.3846153846153846,0.6153846153846154,2,2,0.961236604722876,1
['1000001'],7,2,5,0.2857142857142857,0.7142857142857143,0,2,0.863120568566631,1
"['10', '0', '100', '1110110', '000', '101011', '1111', '10100', '1110']",35,20,15,0.5714285714285714,0.4285714285714285,6,5,0.9852281360342516,0
"['00100', '1', '010', '0101', '100110']",19,8,11,0.4210526315789473,0.5789473684210527,2,4,0.9819407868640976,0
"['01100', '010110', '1', '0110001', '1001011', '0', '00101', '00', '0', '00']",37,15,22,0.4054054054054054,0.5945945945945946,5,6,0.974024864435752,0
"['000100', '001', '1', '101011', '0111100', '0001011']",30,14,16,0.4666666666666667,0.5333333333333333,5,5,0.9967916319816366,1
"['100', '011', '011011', '011111', '111']",21,15,6,0.7142857142857143,0.2857142857142857,7,1,0.863120568566631,0
"['100100', '001111']",12,6,6,0.5,0.5,2,3,1.0,1
"['1011000', '010011', '11', '1100', '111100', '0110100', '0100010', '00', '1001', '0']",46,21,25,0.4565217391304347,0.5434782608695652,7,9,0.994538681650011,0
"['1111', '010', '1001010', '11011', '001100', '0110', '111110', '0111110', '1111', '010']",49,31,18,0.6326530612244898,0.3673469387755102,12,4,0.9486131982385806,1
"['10000', '1001', '1', '01', '0010', '110', '10001']",24,10,14,0.4166666666666667,0.5833333333333334,2,5,0.9798687566511528,0
['1010'],4,2,2,0.5,0.5,0,0,1.0,1
"['0', '1000']",5,1,4,0.2,0.8,0,1,0.7219280948873623,1
"['000', '0101111', '1111', '01001', '111111', '11', '1', '01']",30,21,9,0.7,0.3,9,3,0.8812908992306927,0
"['0001011', '1110', '1100100', '1000', '0010011', '1011110', '1101010', '000', '00']",48,22,26,0.4583333333333333,0.5416666666666666,7,9,0.99498482818597,0
"['1100100', '010101', '00011']",18,8,10,0.4444444444444444,0.5555555555555556,2,3,0.9910760598382222,1
"['11010', '11111', '0111011', '001', '10101', '000', '0000110', '010']",38,20,18,0.5263157894736842,0.4736842105263157,7,5,0.9980008838722996,1
"['1', '1', '000100']",8,3,5,0.375,0.625,1,2,0.954434002924965,1
"['11', '011', '11000', '10110', '10', '01110', '010']",25,14,11,0.56,0.44,5,3,0.9895875212220556,0
"['00', '111010', '011101', '0011101', '1110', '11', '0', '01', '00101', '11101']",40,24,16,0.6,0.4,8,5,0.9709505944546686,0
"['0', '01', '011', '010100', '011001', '010', '001']",24,10,14,0.4166666666666667,0.5833333333333334,2,4,0.9798687566511528,0
"['0110111', '00000', '1110', '01', '100111', '100011', '0010']",34,17,17,0.5,0.5,7,6,1.0,1
"['11', '011001', '110', '111011', '0000111', '0000', '111100', '100101', '000111', '011']",49,27,22,0.5510204081632653,0.4489795918367347,10,8,0.992476003943082,0
"['011001', '01100', '1111000', '0', '10', '10010', '0101', '11110', '00']",37,18,19,0.4864864864864865,0.5135135135135135,6,7,0.9994730201859836,0
"['00', '011', '10100', '00000', '0001', '0110010', '111']",29,11,18,0.3793103448275862,0.6206896551724138,3,7,0.9575534837147482,0
"['10111', '1011011', '00', '101101', '1001011', '1010', '11', '00', '101011', '01110']",46,28,18,0.6086956521739131,0.391304347826087,10,3,0.9656361333706098,0
"['0', '0000001']",8,1,7,0.125,0.875,0,3,0.5435644431995964,1
"['110111', '1111', '1000001', '000111', '00', '0000', '011111', '111', '0011001']",45,25,20,0.5555555555555556,0.4444444444444444,11,8,0.9910760598382222,0
"['111101', '1011', '1', '000', '0001100', '0110', '110']",28,15,13,0.5357142857142857,0.4642857142857143,7,4,0.996316519558962,0
"['1', '00111', '1', '001', '10', '1010', '01']",18,10,8,0.5555555555555556,0.4444444444444444,3,3,0.9910760598382222,0
"['011011', '001', '10', '1101011', '11', '1001101']",27,17,10,0.6296296296296297,0.3703703703703703,7,2,0.9509560484549724,0
"['00110', '0110001', '11']",14,7,7,0.5,0.5,3,3,1.0,1
"['0', '11111', '10', '1100', '000']",15,8,7,0.5333333333333333,0.4666666666666667,4,2,0.9967916319816366,0
"['00100', '110', '11010', '11', '010111', '00', '010', '0010', '100010', '0100']",40,17,23,0.425,0.575,4,7,0.983708262623186,0
"['011', '01', '11010', '00']",12,6,6,0.5,0.5,2,1,1.0,1
['1'],1,1,0,1.0,0.0,0,0,-0.0,1
"['0', '0100101', '000', '01', '101001']",19,7,12,0.3684210526315789,0.631578947368421,1,5,0.9494520153879484,0
"['110', '0000110', '110', '10', '001', '1010', '000110']",28,12,16,0.4285714285714285,0.5714285714285714,5,5,0.9852281360342516,0
"['01', '11', '1', '0110', '000001', '000', '111101', '0110', '011', '1010000']",38,18,20,0.4736842105263157,0.5263157894736842,7,7,0.9980008838722996,0
['00'],2,0,2,0.0,1.0,0,1,-0.0,1
"['0101111', '1100010', '1100101', '1100', '1', '110101', '011010', '1']",39,23,16,0.5897435897435898,0.4102564102564102,7,3,0.97663491144401,0
"['01', '11', '0', '100011']",11,6,5,0.5454545454545454,0.4545454545454545,2,1,0.9940302114769564,0
"['011', '000001', '0', '11101', '11100', '010010', '101011', '1011110', '0100011', '001000']",52,25,27,0.4807692307692308,0.5192307692307693,8,8,0.998932654626058,0
"['1', '100', '000011', '1', '010', '11', '100', '1', '1']",21,11,10,0.5238095238095238,0.4761904761904761,4,4,0.998363672593813,0
"['100010', '1100', '110', '1']",14,7,7,0.5,0.5,2,2,1.0,1
"['1', '111011', '010', '11010', '1']",16,11,5,0.6875,0.3125,4,0,0.8960382325345574,0
['000100'],6,1,5,0.1666666666666666,0.8333333333333334,0,2,0.6500224216483541,1
"['100011', '11', '11111']",13,10,3,0.7692307692307693,0.2307692307692307,4,1,0.7793498372920851,0
"['000100', '0101010', '1010', '010100', '1000000', '10110', '0', '00011', '110']",44,16,28,0.3636363636363636,0.6363636363636364,3,9,0.94566030460064,0
"['00', '001111', '0101100', '01', '001', '1111011', '010010', '1010', '0110111', '0111']",48,27,21,0.5625,0.4375,9,6,0.9886994082884974,0
"['010', '0101110', '111', '1111']",17,12,5,0.7058823529411765,0.2941176470588235,4,1,0.8739810481273578,0
"['00010', '1', '0', '111', '1010011', '00100', '1', '00000']",28,11,17,0.3928571428571428,0.6071428571428571,3,6,0.9666186325481028,0
"['11', '10001', '0110']",11,6,5,0.5454545454545454,0.4545454545454545,2,1,0.9940302114769564,1
"['000101', '1', '0', '0101', '110']",15,7,8,0.4666666666666667,0.5333333333333333,2,2,0.9967916319816366,0
"['11', '0100', '011000']",12,5,7,0.4166666666666667,0.5833333333333334,2,2,0.9798687566511528,1
"['00', '0']",3,0,3,0.0,1.0,0,1,-0.0,0
"['100', '01111', '001', '10000', '010000', '100', '1101011']",32,14,18,0.4375,0.5625,5,7,0.9886994082884974,1
"['00011', '0000100', '0011101', '000', '10']",24,8,16,0.3333333333333333,0.6666666666666666,2,6,0.9182958340544896,1
"['100100', '11', '00', '11101']",15,8,7,0.5333333333333333,0.4666666666666667,2,3,0.9967916319816366,1
"['10', '100', '110', '010', '1001010', '0', '1111010', '00000']",31,13,18,0.4193548387096774,0.5806451612903226,3,7,0.9811522341999132,0
"['1000', '111110', '111', '11110', '01']",20,14,6,0.7,0.3,5,2,0.8812908992306927,1
"['100', '0010111', '10000', '0', '1100', '10', '1111111', '01010']",34,18,16,0.5294117647058824,0.4705882352941176,6,5,0.9975025463691152,0
"['1101', '101001', '011', '0001', '1', '0001010', '11001', '001', '110']",36,18,18,0.5,0.5,6,5,1.0,0
"['00', '0000', '0', '110010', '00000', '010', '00111', '111', '111101', '0001']",39,16,23,0.4102564102564102,0.5897435897435898,6,9,0.97663491144401,0
"['1', '100011', '110000', '100011', '0001101']",26,12,14,0.4615384615384615,0.5384615384615384,5,5,0.9957274520849256,1
"['101', '1110110', '0101111']",17,12,5,0.7058823529411765,0.2941176470588235,5,1,0.8739810481273578,1
"['11010', '101', '1011', '0111100', '00111']",24,15,9,0.625,0.375,6,2,0.954434002924965,1
"['011', '0101', '11000', '1', '011', '1', '110', '1001000', '0110101']",34,18,16,0.5294117647058824,0.4705882352941176,5,4,0.9975025463691152,0
"['001', '1', '11100', '001', '111', '00', '010', '011111', '0011100', '100001']",39,20,19,0.5128205128205128,0.4871794871794871,7,9,0.999525689293649,0
"['10101', '010100', '1110', '1', '101000', '101', '100100', '1101110']",38,20,18,0.5263157894736842,0.4736842105263157,5,4,0.9980008838722996,0
"['11000', '00101', '1', '1', '01000', '10']",19,8,11,0.4210526315789473,0.5789473684210527,2,3,0.9819407868640976,0
"['000', '010', '01', '010', '1', '1001100', '0', '1', '0100101']",28,11,17,0.3928571428571428,0.6071428571428571,2,6,0.9666186325481028,0
"['011', '011', '11', '11', '000', '1', '00001']",19,10,9,0.5263157894736842,0.4736842105263157,4,3,0.9980008838722996,0
"['1001', '0110', '01', '0011100', '0001111', '1', '0011000', '1011100', '1', '000']",43,20,23,0.4651162790697674,0.5348837209302325,6,9,0.996485989886783,0
"['11110', '10', '1000', '111111', '00111', '0101', '001000', '00011', '10', '10']",41,22,19,0.5365853658536586,0.4634146341463415,7,6,0.9961344835095796,0
"['1111', '11', '001110', '111', '100', '000000', '1011101', '01101', '111', '01111']",44,28,16,0.6363636363636364,0.3636363636363636,12,5,0.94566030460064,0
"['100100', '1', '000000', '101', '01', '0', '0', '000', '1']",24,7,17,0.2916666666666667,0.7083333333333334,0,7,0.8708644692353644,0
"['1011001', '1', '001110', '0110', '011011', '1', '010011', '101', '1110']",38,23,15,0.6052631578947368,0.3947368421052631,9,5,0.9677884628267678,0
['1011'],4,3,1,0.75,0.25,1,0,0.8112781244591328,1
"['010101', '1']",7,4,3,0.5714285714285714,0.4285714285714285,1,0,0.9852281360342516,1
"['000111', '00']",8,3,5,0.375,0.625,1,2,0.954434002924965,1
"['0110', '1110', '1', '010', '00', '11', '100001', '1010011', '10111', '1011']",38,22,16,0.5789473684210527,0.4210526315789473,8,4,0.9819407868640976,0
"['01101', '11', '0001111', '000111', '100100', '10']",28,15,13,0.5357142857142857,0.4642857142857143,6,4,0.996316519558962,1
['1'],1,1,0,1.0,0.0,0,0,-0.0,1
"['0', '00000', '1111', '001100', '1110', '011', '010', '010']",29,13,16,0.4482758620689655,0.5517241379310345,5,7,0.9922666387194964,0
"['1', '01011', '101']",9,6,3,0.6666666666666666,0.3333333333333333,1,0,0.9182958340544896,1
"['10', '1000000']",9,2,7,0.2222222222222222,0.7777777777777778,0,3,0.7642045065086203,1
"['1000011', '010101', '1', '000', '0', '1000110']",25,10,15,0.4,0.6,3,5,0.9709505944546686,0
"['1', '1', '0110000', '010', '0100', '1100', '011010']",26,11,15,0.4230769230769231,0.5769230769230769,4,5,0.9828586897127056,0
"['010100', '1', '010', '11111', '1011', '11', '0110111']",28,19,9,0.6785714285714286,0.3214285714285714,7,1,0.9059282160429992,0
"['00000', '011110', '0001', '1111', '0110']",23,11,12,0.4782608695652174,0.5217391304347826,5,5,0.9986359641585718,1
['011'],3,2,1,0.6666666666666666,0.3333333333333333,1,0,0.9182958340544896,1
"['00', '0', '1', '1', '1101011', '11001', '000100', '1', '0001', '100']",31,14,17,0.4516129032258064,0.5483870967741935,5,6,0.9932338197397066,0
"['1010', '00010']",9,3,6,0.3333333333333333,0.6666666666666666,0,2,0.9182958340544896,1
"['001001', '0111000']",13,5,8,0.3846153846153846,0.6153846153846154,1,3,0.961236604722876,1
"['0111011', '110', '10', '010000', '0', '00', '110', '11', '1010001']",33,16,17,0.4848484848484848,0.5151515151515151,5,5,0.9993375041688848,0
"['1011', '01', '0000111', '10111']",18,11,7,0.6111111111111112,0.3888888888888889,4,2,0.964078764808229,1
"['1', '0', '1101100']",9,5,4,0.5555555555555556,0.4444444444444444,2,1,0.9910760598382222,0
"['00', '1', '10', '0001', '11000', '1101011', '1001100', '101010']",34,16,18,0.4705882352941176,0.5294117647058824,5,6,0.9975025463691152,0
"['1101', '000', '0', '10100', '111']",16,8,8,0.5,0.5,2,3,1.0,0
"['1', '0', '101', '000', '110', '1011100', '0001011', '10110', '1', '0001101']",38,19,19,0.5,0.5,5,4,1.0,0
"['1', '110']",4,3,1,0.75,0.25,1,0,0.8112781244591328,1
"['1', '010']",4,2,2,0.5,0.5,0,0,1.0,1
"['10100', '1010011', '01011', '000100', '110', '1111100', '000']",36,17,19,0.4722222222222222,0.5277777777777778,5,6,0.997772472089982,1
"['1110100', '10', '1110000', '110111', '1', '00100', '1111001', '100', '0010110', '10000']",50,25,25,0.5,0.5,9,10,1.0,0
"['001', '111101', '101010', '1010110', '1111101', '1011001', '0', '00', '01', '1']",42,25,17,0.5952380952380952,0.4047619047619047,9,4,0.97366806454962,0
['1010100'],7,3,4,0.4285714285714285,0.5714285714285714,0,1,0.9852281360342516,1
"['11', '100', '01110', '00000', '001011']",21,9,12,0.4285714285714285,0.5714285714285714,3,5,0.9852281360342516,1
"['00', '11', '00100', '1111001', '10011', '111010', '1000100', '001', '1']",38,19,19,0.5,0.5,7,8,1.0,0
"['101', '0101010', '1101']",14,8,6,0.5714285714285714,0.4285714285714285,1,0,0.9852281360342516,1
"['10010', '000', '001100', '0100110']",21,7,14,0.3333333333333333,0.6666666666666666,2,6,0.9182958340544896,1
['0011110'],7,4,3,0.5714285714285714,0.4285714285714285,2,1,0.9852281360342516,1
"['0100', '100', '00011', '1011100', '1100011', '00']",28,12,16,0.4285714285714285,0.5714285714285714,4,6,0.9852281360342516,1
"['10010', '11000', '1111011', '1101', '010', '1010011', '1']",32,19,13,0.59375,0.40625,6,3,0.9744894033980523,0
"['0100001', '00001', '10', '0', '1', '00', '00']",20,5,15,0.25,0.75,1,7,0.8112781244591328,0
['0'],1,0,1,0.0,1.0,0,0,-0.0,1
['101'],3,2,1,0.6666666666666666,0.3333333333333333,0,0,0.9182958340544896,1
"['0', '11', '11']",5,4,1,0.8,0.2,2,0,0.7219280948873623,1
"['01', '1001000', '1000010']",16,5,11,0.3125,0.6875,1,4,0.8960382325345574,1
"['010', '00111']",8,4,4,0.5,0.5,1,1,1.0,1
"['011101', '0101100', '01101', '1010000', '1', '011', '0000']",33,15,18,0.4545454545454545,0.5454545454545454,5,5,0.9940302114769564,0
"['01000', '000', '111100']",14,5,9,0.3571428571428571,0.6428571428571429,2,4,0.9402859586706313,1
['1001001'],7,3,4,0.4285714285714285,0.5714285714285714,0,2,0.9852281360342516,1
"['101', '1', '10', '101101', '00', '110', '01010', '0000', '0100']",30,13,17,0.4333333333333333,0.5666666666666667,3,6,0.9871377743721864,0
"['01100', '11', '0', '10', '011111', '10', '10101']",23,14,9,0.6086956521739131,0.391304347826087,5,2,0.9656361333706098,0
"['01', '1100100', '00', '11', '1', '1100', '110', '000', '0']",25,11,14,0.44,0.56,4,6,0.9895875212220556,0
"['1010', '111', '1001001']",14,8,6,0.5714285714285714,0.4285714285714285,2,2,0.9852281360342516,1
['001'],3,1,2,0.3333333333333333,0.6666666666666666,0,1,0.9182958340544896,1
"['10101', '11', '11', '1', '001', '11', '110100', '111001', '010001']",33,20,13,0.6060606060606061,0.3939393939393939,6,4,0.9672947789468944,0
"['11000', '0110', '0', '1001000', '11', '0', '1001', '1']",25,11,14,0.44,0.56,4,6,0.9895875212220556,0
"['0', '010', '11']",6,3,3,0.5,0.5,1,1,1.0,1
"['11', '11000', '010000', '011001']",19,8,11,0.4210526315789473,0.5789473684210527,3,5,0.9819407868640976,1
"['010000', '111', '1', '0011', '11111', '11', '10100', '1', '0', '0101011']",35,21,14,0.6,0.4,8,5,0.9709505944546686,0
"['00001', '1100111', '000100', '1', '0100001', '00000', '0001100']",38,12,26,0.3157894736842105,0.6842105263157895,3,12,0.8997437586982626,1
"['001001', '10']",8,3,5,0.375,0.625,1,2,0.954434002924965,1
['100'],3,1,2,0.3333333333333333,0.6666666666666666,0,1,0.9182958340544896,1
"['0', '00001', '11', '00001', '1', '1010', '100']",21,8,13,0.3809523809523809,0.6190476190476191,2,5,0.9587118829771318,0
"['0111', '101110', '1011', '100', '000000', '10', '10', '11101']",32,17,15,0.53125,0.46875,5,4,0.9971803988942642,0
"['010000', '00', '1101000', '11111', '0001100', '10111']",32,15,17,0.46875,0.53125,5,6,0.9971803988942642,1
"['011111', '1000', '001', '01001', '10111', '01', '1', '0', '01']",29,16,13,0.5517241379310345,0.4482758620689655,6,4,0.9922666387194964,0
"['01001', '01', '10011', '01000', '0']",18,7,11,0.3888888888888889,0.6111111111111112,2,4,0.964078764808229,0
"['0111', '10001', '1110101', '11100']",21,13,8,0.6190476190476191,0.3809523809523809,6,2,0.9587118829771318,1
"['10', '0011', '010010', '1100111', '10', '1101', '1010', '010']",32,17,15,0.53125,0.46875,6,4,0.9971803988942642,0
"['00000', '010', '00110', '00', '0', '0100010', '0', '0111']",28,8,20,0.2857142857142857,0.7142857142857143,2,8,0.863120568566631,0
"['1100', '11', '1', '10101', '111', '0111011']",22,16,6,0.7272727272727273,0.2727272727272727,7,1,0.8453509366224364,0
"['000010', '011000', '0110', '10000', '0010100', '001']",31,9,22,0.2903225806451613,0.7096774193548387,2,10,0.869137580612638,1
"['1', '1', '101', '01000']",10,5,5,0.5,0.5,1,1,1.0,1
"['100', '01011', '001', '1000', '1', '110']",19,9,10,0.4736842105263157,0.5263157894736842,3,3,0.9980008838722996,0
"['001010', '111', '11', '0100100', '0001', '0', '101', '1100', '1']",31,15,16,0.4838709677419355,0.5161290322580645,3,5,0.9992492479956564,0
"['0100', '0011', '111101', '101100', '011110', '000101', '0', '100011', '100', '11']",44,23,21,0.5227272727272727,0.4772727272727273,9,7,0.9985090989176322,0
"['010110', '0', '001101', '00101', '0010']",22,9,13,0.4090909090909091,0.5909090909090909,2,4,0.9760206482366148,1
"['010100', '10', '000', '111101', '0', '101', '1100', '0', '1000', '111101']",36,18,18,0.5,0.5,5,5,1.0,0
"['010', '1111', '11010']",12,8,4,0.6666666666666666,0.3333333333333333,3,0,0.9182958340544896,1
"['0001', '101', '1101011', '0', '111110', '100000', '00001', '01', '00']",36,16,20,0.4444444444444444,0.5555555555555556,5,6,0.9910760598382222,0
"['0001001', '10111', '11', '011', '0010011']",24,13,11,0.5416666666666666,0.4583333333333333,5,4,0.99498482818597,1
"['001010', '111110', '0']",13,7,6,0.5384615384615384,0.4615384615384615,2,2,0.9957274520849256,1
"['00101', '10', '100']",10,4,6,0.4,0.6,1,2,0.9709505944546686,1
"['11', '0001', '010111']",12,7,5,0.5833333333333334,0.4166666666666667,2,1,0.9798687566511528,1
"['1000', '0', '1111011', '101', '0101100', '000']",25,12,13,0.48,0.52,4,4,0.9988455359952018,0
"['1011010', '010', '01001', '000', '111111', '101', '1', '0100', '11']",34,19,15,0.5588235294117647,0.4411764705882353,6,5,0.9899927915575186,0
"['000', '1010', '101101', '11']",15,8,7,0.5333333333333333,0.4666666666666667,2,1,0.9967916319816366,1
['1000000'],7,1,6,0.1428571428571428,0.8571428571428571,0,3,0.5916727785823275,1
"['001011', '0010', '11', '0010111']",19,10,9,0.5263157894736842,0.4736842105263157,3,3,0.9980008838722996,0
['111001'],6,4,2,0.6666666666666666,0.3333333333333333,1,1,0.9182958340544896,1
['0011'],4,2,2,0.5,0.5,1,1,1.0,1
"['0011101', '0001101', '1010100', '11010']",26,13,13,0.5,0.5,4,3,1.0,1
"['00', '100000', '00010', '10', '0010', '1000', '1', '1011001']",31,10,21,0.3225806451612903,0.6774193548387096,2,8,0.907165767573082,0
"['1101001', '0', '100011', '0', '0', '1011', '01001']",25,12,13,0.48,0.52,3,4,0.9988455359952018,1
"['1000010', '10', '100001', '0111', '11', '1011010', '011', '000']",34,16,18,0.4705882352941176,0.5294117647058824,5,6,0.9975025463691152,0
"['0100001', '00', '0001', '00111', '0111010', '01000']",30,11,19,0.3666666666666666,0.6333333333333333,2,7,0.9480782435939056,0
"['11100', '011100', '0']",12,6,6,0.5,0.5,2,2,1.0,0
"['01', '1001', '010010', '0100', '01100', '01', '0101111']",30,14,16,0.4666666666666667,0.5333333333333333,4,5,0.9967916319816366,0
['00'],2,0,2,0.0,1.0,0,1,-0.0,1
"['11', '1']",3,3,0,1.0,0.0,1,0,-0.0,0
"['1', '1111110', '1', '0100100', '01001', '0100', '011', '1101000', '10', '0000100']",44,20,24,0.4545454545454545,0.5454545454545454,5,8,0.9940302114769564,0
"['11101', '1']",6,5,1,0.8333333333333334,0.1666666666666666,2,0,0.6500224216483541,1
"['110', '111', '010110', '101111', '00']",20,13,7,0.65,0.35,5,1,0.934068055375491,1
"['0010', '11', '00100', '00', '0', '111001', '1', '001', '1011101']",31,15,16,0.4838709677419355,0.5161290322580645,5,6,0.9992492479956564,0
"['01', '010', '10101', '10111', '0', '110', '00011', '010']",27,14,13,0.5185185185185185,0.4814814814814814,4,2,0.9990102708804812,0
['001101'],6,3,3,0.5,0.5,1,1,1.0,1
"['1111110', '010111', '100', '011010', '1']",23,15,8,0.6521739130434783,0.3478260869565217,6,2,0.9321115676166748,0
"['0101000', '101', '1000', '11111', '1110', '111101', '01110']",34,21,13,0.6176470588235294,0.3823529411764705,8,2,0.9596868937742168,1
"['100001', '01111', '1011', '1111', '1111010', '01110', '0', '1']",33,22,11,0.6666666666666666,0.3333333333333333,8,4,0.9182958340544896,0
"['1', '00100', '11110', '01', '01110', '10']",20,11,9,0.55,0.45,3,3,0.9927744539878084,0
"['001010', '000010', '0', '0010111', '1001', '11100', '0001110']",36,15,21,0.4166666666666667,0.5833333333333334,5,8,0.9798687566511528,0
"['011001', '110111', '0', '0011100', '01111', '101100', '0100', '0011', '111101', '1110']",49,29,20,0.5918367346938775,0.4081632653061224,12,6,0.9755259511264972,0
"['01', '00000', '01', '1000101', '011010', '1100010', '1101001', '1']",37,16,21,0.4324324324324324,0.5675675675675675,5,6,0.9867867202680318,0
"['01101', '0001011']",12,6,6,0.5,0.5,2,1,1.0,1
"['100010', '010', '011000', '10101', '010110', '010000']",32,12,20,0.375,0.625,2,7,0.954434002924965,1
"['0', '000', '01']",6,1,5,0.1666666666666666,0.8333333333333334,0,2,0.6500224216483541,0
"['0010', '1001011', '011101', '111', '1110']",24,15,9,0.625,0.375,5,2,0.954434002924965,1
"['110000', '0101100', '1001001', '010100', '0', '10100', '1', '00101', '0001']",42,16,26,0.3809523809523809,0.6190476190476191,2,9,0.9587118829771318,0
"['00100', '1110010', '001111']",18,9,9,0.5,0.5,3,4,1.0,1
"['1', '110', '1001', '1101', '10011', '1001000', '001', '00', '0100011']",36,17,19,0.4722222222222222,0.5277777777777778,5,7,0.997772472089982,0
"['1111', '11110', '0000', '0', '0011101', '010', '110110', '011', '00']",35,19,16,0.5428571428571428,0.4571428571428571,8,6,0.9946937953613058,0
"['00000', '10101', '1011']",14,6,8,0.4285714285714285,0.5714285714285714,2,2,0.9852281360342516,1
"['10100', '01110', '111', '10001', '1111', '001101', '0']",29,17,12,0.5862068965517241,0.4137931034482758,6,3,0.9784493292686188,0
"['0001101', '0010', '01', '000']",16,5,11,0.3125,0.6875,1,4,0.8960382325345574,1
"['010', '0101', '00', '01101', '01', '1100', '10', '100', '0000', '0000']",33,11,22,0.3333333333333333,0.6666666666666666,2,8,0.9182958340544896,0
"['000', '1', '101111', '000', '1011100', '0', '1100']",25,12,13,0.48,0.52,5,4,0.9988455359952018,0
"['0100', '10100', '110011', '110110', '0101011', '00', '1011000']",37,18,19,0.4864864864864865,0.5135135135135135,6,6,0.9994730201859836,1
"['01100', '0101010', '111', '111', '11', '11']",22,15,7,0.6818181818181818,0.3181818181818182,6,1,0.9023932827949788,0
"['0', '0', '0010010', '01', '010100', '111', '1', '1100']",25,11,14,0.44,0.56,3,6,0.9895875212220556,0
"['1101', '11']",6,5,1,0.8333333333333334,0.1666666666666666,2,0,0.6500224216483541,1
"['000', '0100110', '0100110', '11', '0110010', '000', '00011']",34,13,21,0.3823529411764705,0.6176470588235294,5,9,0.9596868937742168,0
"['001101', '1011', '10101', '100', '0110111', '110']",28,17,11,0.6071428571428571,0.3928571428571428,7,2,0.9666186325481028,1
"['000001', '1', '01', '1', '10', '1101001', '1011', '0101', '001', '1110']",34,18,16,0.5294117647058824,0.4705882352941176,7,4,0.9975025463691152,0
"['01', '0101', '10', '00100']",13,5,8,0.3846153846153846,0.6153846153846154,1,2,0.961236604722876,0
"['11', '10101', '01']",9,6,3,0.6666666666666666,0.3333333333333333,1,0,0.9182958340544896,1
"['0', '00']",3,0,3,0.0,1.0,0,1,-0.0,0
"['011100', '01', '010101', '1', '10110', '0']",21,11,10,0.5238095238095238,0.4761904761904761,3,2,0.998363672593813,0
"['1', '100', '0', '11111', '001110', '000011', '010001', '00', '100111', '101']",39,20,19,0.5128205128205128,0.4871794871794871,7,7,0.999525689293649,0
"['1', '11101', '110', '1']",10,8,2,0.8,0.2,3,0,0.7219280948873623,0
"['1100111', '0', '1001010']",15,8,7,0.5333333333333333,0.4666666666666667,2,2,0.9967916319816366,1
"['101', '01', '0', '1']",7,4,3,0.5714285714285714,0.4285714285714285,0,0,0.9852281360342516,0
"['11000', '011', '100000', '10', '11101', '0101', '01001', '100110', '0100']",40,18,22,0.45,0.55,5,8,0.9927744539878084,0
"['1', '1', '11']",4,4,0,1.0,0.0,2,0,-0.0,0
"['1', '00', '1101010', '100', '110101']",19,10,9,0.5263157894736842,0.4736842105263157,2,2,0.9980008838722996,0
"['1000101', '0', '11', '00101', '011', '11']",20,11,9,0.55,0.45,3,2,0.9927744539878084,0
"['00', '111', '0000100', '1010100', '1011', '11001', '0', '001101', '0', '110']",39,18,21,0.4615384615384615,0.5384615384615384,5,7,0.9957274520849256,0
"['11101', '1000101', '1000110']",19,10,9,0.5263157894736842,0.4736842105263157,4,2,0.9980008838722996,1
"['110', '011111', '0111', '10', '00100', '1111']",24,16,8,0.6666666666666666,0.3333333333333333,7,3,0.9182958340544896,0
"['110100', '110111', '1', '1001001', '01', '00', '1010', '100000']",34,16,18,0.4705882352941176,0.5294117647058824,4,6,0.9975025463691152,0
"['100011', '10001', '0', '00', '1', '001', '111', '0', '111']",25,13,12,0.52,0.48,4,4,0.9988455359952018,0
"['0001', '0111111', '010101', '1001', '000', '011011', '10100', '01']",37,19,18,0.5135135135135135,0.4864864864864865,6,5,0.9994730201859836,0
['10110'],5,3,2,0.6,0.4,1,0,0.9709505944546686,1
"['11101', '1010010', '00', '01', '10', '00101', '1', '001000', '0111']",34,16,18,0.4705882352941176,0.5294117647058824,5,7,0.9975025463691152,0
"['100', '1100010', '0100', '01', '1', '10101', '0100010', '11', '00', '111']",36,17,19,0.4722222222222222,0.5277777777777778,4,6,0.997772472089982,0
"['0111', '010000', '111', '1110011', '010', '01000', '1100', '0011', '100111', '1']",43,23,20,0.5348837209302325,0.4651162790697674,9,8,0.996485989886783,0
"['11011', '0001', '01', '1']",12,7,5,0.5833333333333334,0.4166666666666667,3,1,0.9798687566511528,0
"['0010100', '011', '11000', '1001111']",22,11,11,0.5,0.5,4,4,1.0,1
"['1011', '1', '1111']",9,8,1,0.8888888888888888,0.1111111111111111,3,0,0.5032583347756457,0
"['10010', '0', '0001', '110', '00', '0', '100']",19,6,13,0.3157894736842105,0.6842105263157895,1,6,0.8997437586982626,0
"['0111001', '10', '001', '0101', '0100011']",23,11,12,0.4782608695652174,0.5217391304347826,3,3,0.9986359641585718,1
['0001'],4,1,3,0.25,0.75,0,1,0.8112781244591328,1
"['001101', '0', '10', '0001', '0', '1011', '0001100', '11111', '101001']",36,18,18,0.5,0.5,6,6,1.0,0
"['01010', '001']",8,3,5,0.375,0.625,0,1,0.954434002924965,1
"['000011', '10', '00101', '0111']",17,8,9,0.4705882352941176,0.5294117647058824,2,3,0.9975025463691152,1
"['1101111', '100', '011', '110101', '0000000', '0']",27,13,14,0.4814814814814814,0.5185185185185185,5,5,0.9990102708804812,0
"['0010', '1010', '00', '1100111', '1', '00000', '1', '000001', '1']",31,12,19,0.3870967741935484,0.6129032258064516,4,7,0.9629004147713268,0
"['0010', '0', '10001', '1', '0']",12,4,8,0.3333333333333333,0.6666666666666666,1,3,0.9182958340544896,0
"['01', '0']",3,1,2,0.3333333333333333,0.6666666666666666,0,0,0.9182958340544896,1
"['1101', '001', '1011011']",14,9,5,0.6428571428571429,0.3571428571428571,4,1,0.9402859586706313,1
"['00', '00110', '001111', '1', '001', '11', '0100', '1111', '00000']",32,15,17,0.46875,0.53125,6,7,0.9971803988942642,0
"['1001', '1000', '00101', '011']",16,7,9,0.4375,0.5625,2,3,0.9886994082884974,1
"['00', '1010', '000101', '1', '0111100', '1111100', '1', '011110', '0', '1100111']",42,24,18,0.5714285714285714,0.4285714285714285,9,7,0.9852281360342516,0
"['100000', '0', '1', '0', '01111', '1000']",18,7,11,0.3888888888888889,0.6111111111111112,2,5,0.964078764808229,0
['010101'],6,3,3,0.5,0.5,0,0,1.0,1
"['0010', '011000', '0100110', '11110', '1011000']",29,13,16,0.4482758620689655,0.5517241379310345,5,6,0.9922666387194964,1
['111011'],6,5,1,0.8333333333333334,0.1666666666666666,2,0,0.6500224216483541,1
"['1', '10111', '0100000', '11000', '0101000', '01']",27,11,16,0.4074074074074074,0.5925925925925926,3,6,0.975119064940866,0
"['0', '1000', '100', '0101', '01', '100100', '011', '1']",24,10,14,0.4166666666666667,0.5833333333333334,2,4,0.9798687566511528,0
"['11000', '1001111', '010101', '00111']",23,13,10,0.5652173913043478,0.4347826086956521,4,3,0.9876925088958034,1
"['01001', '011100', '110110', '11100', '01011', '1001110']",34,19,15,0.5588235294117647,0.4411764705882353,6,4,0.9899927915575186,1
"['001100', '010', '01110']",14,6,8,0.4285714285714285,0.5714285714285714,2,3,0.9852281360342516,1
"['0110010', '0101101', '10110', '011', '001', '0', '0000', '01', '0', '0']",34,14,20,0.4117647058823529,0.5882352941176471,5,8,0.9774178175281716,0
"['00000', '00', '1100111', '101', '0110', '110101', '00', '0111', '00']",35,16,19,0.4571428571428571,0.5428571428571428,6,6,0.9946937953613058,0
"['011', '000', '1001100', '011', '1100000', '0', '011100', '0001']",34,13,21,0.3823529411764705,0.6176470588235294,5,8,0.9596868937742168,0
"['011', '110010', '001', '1100', '000', '00111', '0110111', '11', '0001', '01011']",42,22,20,0.5238095238095238,0.4761904761904761,8,6,0.998363672593813,0
"['0', '1100000', '1011']",12,5,7,0.4166666666666667,0.5833333333333334,2,2,0.9798687566511528,1
"['1', '0110', '101', '00', '0', '000110']",17,7,10,0.4117647058823529,0.5882352941176471,2,3,0.9774178175281716,0
"['0000011', '1001', '0110011', '111', '0000', '010101', '1110110', '01', '011011']",46,24,22,0.5217391304347826,0.4782608695652174,9,7,0.9986359641585718,0
"['11', '1000101', '111101', '10111', '1001', '0', '1010']",29,18,11,0.6206896551724138,0.3793103448275862,6,2,0.9575534837147482,0
"['1001', '1', '00', '1', '1110101', '00000', '10', '101011']",28,14,14,0.5,0.5,4,4,1.0,0
"['000', '1110', '11110', '110']",15,9,6,0.6,0.4,4,1,0.9709505944546686,1
"['101010', '10']",8,4,4,0.5,0.5,0,0,1.0,0
"['011101', '11111', '101', '01111', '00', '0110001', '01', '100']",33,20,13,0.6060606060606061,0.3939393939393939,8,3,0.9672947789468944,0
"['110110', '11111', '0111']",15,12,3,0.8,0.2,5,0,0.7219280948873623,1
"['10', '0111']",6,4,2,0.6666666666666666,0.3333333333333333,1,1,0.9182958340544896,1
"['00', '00', '11000', '0110', '000100', '100', '1', '111111', '1011001']",36,17,19,0.4722222222222222,0.5277777777777778,7,9,0.997772472089982,0
"['001011', '00']",8,3,5,0.375,0.625,1,2,0.954434002924965,1
"['11', '1000', '10000', '110110', '10001', '100011', '1010000']",35,15,20,0.4285714285714285,0.5714285714285714,5,7,0.9852281360342516,0
['00'],2,0,2,0.0,1.0,0,1,-0.0,1
"['0100000', '111', '1101', '0001', '11100', '0000101', '11011', '00', '110', '1100010']",47,22,25,0.4680851063829787,0.5319148936170213,8,8,0.9970590569034106,0
"['011', '1010011', '01', '001', '01111', '111101', '1010', '1101101', '11', '00']",41,26,15,0.6341463414634146,0.3658536585365853,10,3,0.9474351361840307,0
"['111101', '1111011', '0110101']",20,15,5,0.75,0.25,6,0,0.8112781244591328,1
"['1001', '1000']",8,3,5,0.375,0.625,1,2,0.954434002924965,1
"['01', '101', '11', '001', '1', '01100', '111010']",22,13,9,0.5909090909090909,0.4090909090909091,5,2,0.9760206482366148,0
['101110'],6,4,2,0.6666666666666666,0.3333333333333333,1,0,0.9182958340544896,1
"['10010', '000', '011010', '00', '110', '0110011']",26,11,15,0.4230769230769231,0.5769230769230769,4,6,0.9828586897127056,0
"['0111', '1010111']",11,8,3,0.7272727272727273,0.2727272727272727,3,0,0.8453509366224364,1
"['0', '1001', '11', '1001', '0', '00', '011', '0']",18,8,10,0.4444444444444444,0.5555555555555556,3,4,0.9910760598382222,0
"['1', '0101', '101111', '10', '1']",14,10,4,0.7142857142857143,0.2857142857142857,3,0,0.863120568566631,0
"['00010', '0', '10001', '11110', '1', '101', '00', '1', '0010', '1100100']",34,15,19,0.4411764705882353,0.5588235294117647,4,7,0.9899927915575186,0
"['10110', '10110', '10101', '1', '101', '00000', '1']",25,13,12,0.52,0.48,3,2,0.9988455359952018,0
"['0000', '00101', '0011', '1100110', '00']",22,8,14,0.3636363636363636,0.6363636363636364,3,6,0.94566030460064,0
['1010100'],7,3,4,0.4285714285714285,0.5714285714285714,0,1,0.9852281360342516,1
['101'],3,2,1,0.6666666666666666,0.3333333333333333,0,0,0.9182958340544896,1
"['010010', '100', '11111']",14,8,6,0.5714285714285714,0.4285714285714285,2,2,0.9852281360342516,1
"['01', '10', '010011']",10,5,5,0.5,0.5,2,2,1.0,1
"['11', '1010100', '1', '11']",12,8,4,0.6666666666666666,0.3333333333333333,2,1,0.9182958340544896,0
"['0111110', '10', '11001', '100', '001', '01']",22,12,10,0.5454545454545454,0.4545454545454545,4,3,0.9940302114769564,0
"['0', '0', '111']",5,3,2,0.6,0.4,1,1,0.9709505944546686,1
"['01', '1', '1011110', '000101', '0000', '11101']",25,13,12,0.52,0.48,4,4,0.9988455359952018,0
"['0', '001101', '0110', '0', '01']",14,6,8,0.4285714285714285,0.5714285714285714,2,2,0.9852281360342516,1
"['0011000', '1', '0']",9,3,6,0.3333333333333333,0.6666666666666666,1,2,0.9182958340544896,0
"['0110110', '0100', '011000', '0', '010', '10100']",26,10,16,0.3846153846153846,0.6153846153846154,3,5,0.961236604722876,0
"['111111', '000', '101', '0', '00111', '00', '101', '011', '11111', '01001']",36,22,14,0.6111111111111112,0.3888888888888889,7,4,0.964078764808229,0
['00'],2,0,2,0.0,1.0,0,1,-0.0,1
"['010101', '00100']",11,4,7,0.3636363636363636,0.6363636363636364,0,2,0.94566030460064,1
"['110100', '00011', '001000', '0000', '11', '1', '1', '000001', '1111111', '1100']",42,20,22,0.4761904761904761,0.5238095238095238,9,9,0.998363672593813,0
"['0001101', '0111011', '100000', '11', '0001011']",29,14,15,0.4827586206896552,0.5172413793103449,5,4,0.9991421039919088,1
"['1000100', '11', '11001', '0', '01', '0111000', '101']",27,13,14,0.4814814814814814,0.5185185185185185,3,5,0.9990102708804812,0
"['001001', '001111', '0111011']",19,11,8,0.5789473684210527,0.4210526315789473,4,3,0.9819407868640976,1
"['1', '001']",4,2,2,0.5,0.5,0,1,1.0,1
"['00111', '10001', '1111', '1111', '10110', '1010', '100010', '110011']",39,24,15,0.6153846153846154,0.3846153846153846,10,4,0.961236604722876,1
"['1', '0110']",5,3,2,0.6,0.4,1,0,0.9709505944546686,1
"['11110', '101101']",11,8,3,0.7272727272727273,0.2727272727272727,3,0,0.8453509366224364,1
"['11001', '100100']",11,5,6,0.4545454545454545,0.5454545454545454,2,3,0.9940302114769564,1
"['000', '11110', '01000', '10', '1', '0100', '101']",23,10,13,0.4347826086956521,0.5652173913043478,2,4,0.9876925088958034,0
"['111110', '10', '1', '0', '11', '00']",14,9,5,0.6428571428571429,0.3571428571428571,3,1,0.9402859586706313,0
"['00', '0', '00000', '0', '0111110', '11', '110110', '10111']",29,15,14,0.5172413793103449,0.4827586206896552,6,5,0.9991421039919088,0
"['0001101', '1', '0', '010000', '00001', '110010', '10', '0110010', '10']",37,14,23,0.3783783783783784,0.6216216216216216,4,9,0.9568886656798212,0
"['10', '10', '0', '100100', '1001', '10', '0']",18,7,11,0.3888888888888889,0.6111111111111112,1,5,0.964078764808229,0
"['0100', '0101011', '10010', '0', '100', '1', '1010010', '10011', '11010', '1111011']",45,24,21,0.5333333333333333,0.4666666666666667,7,6,0.9967916319816366,0
['11101'],5,4,1,0.8,0.2,1,0,0.7219280948873623,1
"['001011', '110', '0111']",13,8,5,0.6153846153846154,0.3846153846153846,3,2,0.961236604722876,1
"['0010', '11111', '110', '1011000', '11']",21,13,8,0.6190476190476191,0.3809523809523809,5,2,0.9587118829771318,0
"['101111', '111110', '110', '11010', '0000', '01010', '0010001']",36,19,17,0.5277777777777778,0.4722222222222222,6,5,0.997772472089982,1
"['011110', '110', '0', '0011110']",17,10,7,0.5882352941176471,0.4117647058823529,5,2,0.9774178175281716,0
"['0', '11010', '01110', '0', '1', '0', '0110', '011110']",24,13,11,0.5416666666666666,0.4583333333333333,5,4,0.99498482818597,0
"['1010', '111']",7,5,2,0.7142857142857143,0.2857142857142857,1,0,0.863120568566631,1
"['1', '00', '0', '10', '1001', '1', '10', '1110', '11100', '1001']",26,14,12,0.5384615384615384,0.4615384615384615,3,4,0.9957274520849256,0
"['100111', '00010', '101', '101000', '0', '1111110', '01']",30,16,14,0.5333333333333333,0.4666666666666667,5,5,0.9967916319816366,0
"['01', '1', '000101', '01111', '00011', '010', '000']",25,11,14,0.44,0.56,4,4,0.9895875212220556,0
"['110', '0100110', '1', '01001']",16,8,8,0.5,0.5,2,3,1.0,1
"['1100101', '1100', '0101', '1', '1001111', '001011', '101', '010000']",38,20,18,0.5263157894736842,0.4736842105263157,6,6,0.9980008838722996,0
"['0101', '010001', '1110', '01']",16,8,8,0.5,0.5,2,2,1.0,0
"['10011', '1110010']",12,7,5,0.5833333333333334,0.4166666666666667,2,2,0.9798687566511528,1
"['01001', '111000', '0011', '11100', '00', '1100010', '0', '0100001']",37,15,22,0.4054054054054054,0.5945945945945946,5,9,0.974024864435752,0
"['10', '111001', '1', '1']",10,7,3,0.7,0.3,2,1,0.8812908992306927,1
"['10', '1000', '0', '0', '0000010', '01', '000111', '01011', '1010']",32,12,20,0.375,0.625,2,7,0.954434002924965,0
"['1010', '11', '00', '0', '10']",11,5,6,0.4545454545454545,0.5454545454545454,1,1,0.9940302114769564,0
"['11', '10000', '011', '10101', '001', '10', '1011', '100', '1', '0001']",32,16,16,0.5,0.5,4,5,1.0,0
"['000', '101011']",9,4,5,0.4444444444444444,0.5555555555555556,1,1,0.9910760598382222,1
"['100', '1010101', '110001', '1', '0100100', '01']",26,12,14,0.4615384615384615,0.5384615384615384,2,4,0.9957274520849256,0
"['010101', '0011111', '1001001', '1000011', '101101', '1001', '00']",39,20,19,0.5128205128205128,0.4871794871794871,7,7,0.999525689293649,0
"['01010', '111', '1000', '1111110', '000000', '0', '1010110', '0011', '011101']",43,22,21,0.5116279069767442,0.4883720930232558,8,6,0.999609836367807,0
"['01', '001000']",8,2,6,0.25,0.75,0,2,0.8112781244591328,1
"['0', '001', '0', '11', '10110', '00', '11', '11010', '1010']",25,13,12,0.52,0.48,4,2,0.9988455359952018,0
"['0101', '0001', '01101', '111011']",19,11,8,0.5789473684210527,0.4210526315789473,4,1,0.9819407868640976,1
"['1011011', '10', '1111101', '0111000', '101101']",29,19,10,0.6551724137931034,0.3448275862068966,6,1,0.9293636260137188,1
"['111', '1']",4,4,0,1.0,0.0,2,0,-0.0,0
"['110100', '001', '1001011', '1011011', '10111', '1110', '1000111', '1', '01']",42,26,16,0.6190476190476191,0.3809523809523809,10,4,0.9587118829771318,0
"['101', '01']",5,3,2,0.6,0.4,0,0,0.9709505944546686,1
"['000111', '1', '011011', '1111110', '111', '101000', '1', '0', '01', '1100010']",40,24,16,0.6,0.4,10,4,0.9709505944546686,0
"['10', '0000', '101', '101']",12,5,7,0.4166666666666667,0.5833333333333334,1,2,0.9798687566511528,1
"['0', '000110']",7,2,5,0.2857142857142857,0.7142857142857143,1,2,0.863120568566631,1
"['10010', '000', '0111', '0010001', '00', '00011', '010000', '1001111']",39,15,24,0.3846153846153846,0.6153846153846154,4,10,0.961236604722876,0
"['1', '011000']",7,3,4,0.4285714285714285,0.5714285714285714,1,1,0.9852281360342516,1
"['0101', '010001', '11110', '010', '1001101', '100011']",31,16,15,0.5161290322580645,0.4838709677419355,5,4,0.9992492479956564,1
"['0100', '1011011', '11000']",16,8,8,0.5,0.5,3,2,1.0,1
"['0011000', '011110', '1']",14,7,7,0.5,0.5,3,3,1.0,1
"['11010', '11011', '110001', '00', '0101101', '1', '0100', '001', '101', '010101']",42,22,20,0.5238095238095238,0.4761904761904761,7,4,0.998363672593813,0
"['00000', '0011010', '0', '10', '0010000']",22,5,17,0.2272727272727272,0.7727272727272727,1,7,0.7732266742876346,0
"['0', '11011']",6,4,2,0.6666666666666666,0.3333333333333333,2,0,0.9182958340544896,1
"['11111', '1010010', '1', '1', '000011', '101001', '11010', '0']",32,18,14,0.5625,0.4375,6,5,0.9886994082884974,0
"['100', '0001100', '1111', '100', '010']",20,9,11,0.45,0.55,3,4,0.9927744539878084,1
"['00011', '010', '11101', '1', '00101']",19,10,9,0.5263157894736842,0.4736842105263157,3,2,0.9980008838722996,0
"['10', '001010', '0001001', '0001', '0011', '010101', '01', '101', '0111111', '100']",44,21,23,0.4772727272727273,0.5227272727272727,5,7,0.9985090989176322,0
"['001111', '10', '000', '111', '0', '00', '1', '010', '001000']",27,11,16,0.4074074074074074,0.5925925925925926,3,6,0.975119064940866,0
"['00100', '11111']",10,6,4,0.6,0.4,2,2,0.9709505944546686,1
"['010111', '10', '0', '01']",11,6,5,0.5454545454545454,0.4545454545454545,2,1,0.9940302114769564,0
"['10', '1', '0111', '0', '11', '1']",11,8,3,0.7272727272727273,0.2727272727272727,2,0,0.8453509366224364,0
"['000', '011110', '10', '1100', '001101', '110', '100', '1']",28,14,14,0.5,0.5,5,5,1.0,0
"['00', '100010', '1110']",12,5,7,0.4166666666666667,0.5833333333333334,1,2,0.9798687566511528,1
['1111'],4,4,0,1.0,0.0,2,0,-0.0,1
"['11', '1101', '00']",8,5,3,0.625,0.375,2,1,0.954434002924965,1
"['101', '0111100', '0111100', '000100', '1', '10101', '01110']",34,18,16,0.5294117647058824,0.4705882352941176,6,4,0.9975025463691152,0
"['1', '0', '10', '110', '0000111', '111', '010', '001000', '11100', '00']",33,15,18,0.4545454545454545,0.5454545454545454,5,6,0.9940302114769564,0
"['10', '0']",3,1,2,0.3333333333333333,0.6666666666666666,0,1,0.9182958340544896,1
"['0011', '1111', '00', '000110', '101', '101100']",25,13,12,0.52,0.48,6,4,0.9988455359952018,1
"['001', '1001011', '0', '1', '1001']",16,8,8,0.5,0.5,3,3,1.0,0
"['0101', '0111', '0', '0110011']",16,9,7,0.5625,0.4375,3,2,0.9886994082884974,1
"['10', '1111', '010111']",12,9,3,0.75,0.25,3,0,0.8112781244591328,1
"['111000', '111000']",12,6,6,0.5,0.5,2,2,1.0,1
"['01001', '10010', '111101', '0', '11111', '1000000']",29,15,14,0.5172413793103449,0.4827586206896552,6,5,0.9991421039919088,0
"['10001', '1011100', '001010', '111001', '00', '0001001', '00110', '01', '01']",42,18,24,0.4285714285714285,0.5714285714285714,4,9,0.9852281360342516,0
"['1111010', '001', '0101', '110', '101', '0011', '1', '111011', '1']",32,21,11,0.65625,0.34375,7,2,0.9283620723948676,0
"['0011011', '110', '00011', '111']",18,11,7,0.6111111111111112,0.3888888888888889,5,3,0.964078764808229,1
"['10011', '11101', '10', '01011', '111000', '00110', '000100', '0111000', '1']",42,21,21,0.5,0.5,7,8,1.0,0
"['10', '00', '0011', '0010011', '01001']",20,8,12,0.4,0.6,2,5,0.9709505944546686,1
"['01', '010111', '11000', '011', '1010', '01110', '1011', '010']",32,18,14,0.5625,0.4375,5,3,0.9886994082884974,0
"['1', '10100', '00101', '110011', '011010', '11', '00']",27,14,13,0.5185185185185185,0.4814814814814814,5,4,0.9990102708804812,0
"['0001', '110111']",10,6,4,0.6,0.4,2,1,0.9709505944546686,1
"['01101', '10', '1', '110', '0000', '0011', '11', '1', '11']",24,14,10,0.5833333333333334,0.4166666666666667,6,3,0.9798687566511528,0
"['01101', '101010', '0', '0', '1', '101101', '1101110', '11101', '0001']",36,21,15,0.5833333333333334,0.4166666666666667,7,2,0.9798687566511528,0
"['10101', '1111000', '100']",15,8,7,0.5333333333333333,0.4666666666666667,2,2,0.9967916319816366,1
"['00', '01', '01', '101011', '110', '0100']",19,9,10,0.4736842105263157,0.5263157894736842,3,3,0.9980008838722996,0
"['0', '0', '0100101', '110001', '01', '01010', '1']",23,10,13,0.4347826086956521,0.5652173913043478,1,3,0.9876925088958034,0
"['0010100', '00011', '1001011']",19,8,11,0.4210526315789473,0.5789473684210527,2,4,0.9819407868640976,1
"['11100', '0', '0101', '1010010', '0100000', '100']",27,10,17,0.3703703703703703,0.6296296296296297,2,7,0.9509560484549724,0
"['0111', '1001001']",11,6,5,0.5454545454545454,0.4545454545454545,2,2,0.9940302114769564,1
"['00110', '110010', '11100', '111', '00', '001101', '0010', '100011', '10']",39,19,20,0.4871794871794871,0.5128205128205128,6,7,0.999525689293649,0
"['01010', '1111010', '010', '010000', '10', '0', '10', '00', '11', '11']",32,15,17,0.46875,0.53125,4,6,0.9971803988942642,0
"['100100', '0101', '0000100', '0', '111', '011110', '0111101']",34,17,17,0.5,0.5,5,6,1.0,1
"['101010', '0100', '1', '00000', '0', '10']",19,6,13,0.3157894736842105,0.6842105263157895,0,5,0.8997437586982626,0
"['111', '0']",4,3,1,0.75,0.25,1,0,0.8112781244591328,1
['011'],3,2,1,0.6666666666666666,0.3333333333333333,1,0,0.9182958340544896,1
"['01100', '011111', '1110111', '1']",19,14,5,0.7368421052631579,0.2631578947368421,7,1,0.8314743880097293,0
"['11111', '000010', '0001110']",18,9,9,0.5,0.5,3,4,1.0,1
"['0', '1', '1', '010010', '0000', '111', '000', '0100', '01']",25,9,16,0.36,0.64,2,6,0.9426831892554922,0
"['10001', '10010', '1', '11', '001000', '000', '0010000', '1000', '0']",34,10,24,0.2941176470588235,0.7058823529411765,2,11,0.8739810481273578,0
['100010'],6,2,4,0.3333333333333333,0.6666666666666666,0,1,0.9182958340544896,1
"['01', '1', '10001', '0111', '110', '111', '1', '01', '00']",23,14,9,0.6086956521739131,0.391304347826087,5,2,0.9656361333706098,0
"['001001', '1', '011110', '001001', '1', '0111', '10', '001000', '0000010', '10']",41,17,24,0.4146341463414634,0.5853658536585366,6,9,0.9788698505067784,0
"['011001', '1', '1', '110010', '1000', '1011001', '000', '0']",29,13,16,0.4482758620689655,0.5517241379310345,4,6,0.9922666387194964,0
"['0100001', '01001', '0', '100', '1001', '1100']",24,9,15,0.375,0.625,1,6,0.954434002924965,0
['1'],1,1,0,1.0,0.0,0,0,-0.0,1
"['1100101', '110011', '100011', '1100', '10', '01101', '000', '10011', '10']",40,21,19,0.525,0.475,7,7,0.99819587904281,0
"['100', '001', '01']",8,3,5,0.375,0.625,0,2,0.954434002924965,1
"['10', '1100', '11011', '11', '0000']",17,9,8,0.5294117647058824,0.4705882352941176,4,3,0.9975025463691152,1
['0000000'],7,0,7,0.0,1.0,0,3,-0.0,1
"['11', '0110', '100001']",12,6,6,0.5,0.5,2,2,1.0,1
"['101', '01100', '1010100', '1', '01100', '00100', '11']",28,13,15,0.4642857142857143,0.5357142857142857,3,5,0.996316519558962,0
"['101', '0111', '111', '1101010', '0', '1', '01000', '0']",25,14,11,0.56,0.44,4,3,0.9895875212220556,0
"['011100', '01', '110101', '0000', '1111100', '0011011', '1110']",36,20,16,0.5555555555555556,0.4444444444444444,7,5,0.9910760598382222,1
"['1000110', '0']",8,3,5,0.375,0.625,1,2,0.954434002924965,1
"['001', '000', '0', '0', '0010', '1', '1', '0', '1100', '01']",21,7,14,0.3333333333333333,0.6666666666666666,2,5,0.9182958340544896,0
"['1', '110110']",7,5,2,0.7142857142857143,0.2857142857142857,2,0,0.863120568566631,1
"['0010110', '1111', '0001001', '0', '01', '010', '100', '0']",28,12,16,0.4285714285714285,0.5714285714285714,3,5,0.9852281360342516,0
"['011110', '110101', '111001', '0111', '1', '00110', '11', '1100', '0011000', '0']",42,24,18,0.5714285714285714,0.4285714285714285,11,6,0.9852281360342516,0
"['1000', '110010', '00110', '1100000', '00', '1', '0', '00']",28,9,19,0.3214285714285714,0.6785714285714286,3,7,0.9059282160429992,0
"['0000111', '00010', '0101110', '010', '11', '1100011', '01', '101', '01010', '001110']",47,23,24,0.4893617021276595,0.5106382978723404,7,7,0.9996734260048916,0
['1011000'],7,3,4,0.4285714285714285,0.5714285714285714,1,1,0.9852281360342516,1
"['1', '0', '0', '11', '01101', '001', '001']",16,8,8,0.5,0.5,2,3,1.0,0
['0100010'],7,2,5,0.2857142857142857,0.7142857142857143,0,1,0.863120568566631,1
['1'],1,1,0,1.0,0.0,0,0,-0.0,1
"['001', '0']",4,1,3,0.25,0.75,0,1,0.8112781244591328,1
['010100'],6,2,4,0.3333333333333333,0.6666666666666666,0,1,0.9182958340544896,1
"['1', '11', '011', '0']",7,5,2,0.7142857142857143,0.2857142857142857,2,0,0.863120568566631,0
"['011', '0111100', '01', '111100', '111011']",24,16,8,0.6666666666666666,0.3333333333333333,7,2,0.9182958340544896,1
"['01110', '0001011', '1011']",16,9,7,0.5625,0.4375,3,2,0.9886994082884974,1
['0010'],4,1,3,0.25,0.75,0,1,0.8112781244591328,1
['10011'],5,3,2,0.6,0.4,1,1,0.9709505944546686,1
"['1001111', '001110', '11011', '11', '01001', '1', '10', '01111']",33,22,11,0.6666666666666666,0.3333333333333333,9,4,0.9182958340544896,0
"['000', '10001', '10010', '11110']",18,8,10,0.4444444444444444,0.5555555555555556,3,3,0.9910760598382222,1
"['11', '001010', '101100', '110011', '100', '0011', '0', '0110111']",35,19,16,0.5428571428571428,0.4571428571428571,7,6,0.9946937953613058,0
"['0100000', '10']",9,2,7,0.2222222222222222,0.7777777777777778,0,2,0.7642045065086203,1
"['0', '101010', '1010001', '011', '011', '1011011', '0010']",31,16,15,0.5161290322580645,0.4838709677419355,4,2,0.9992492479956564,0
"['00111', '0101']",9,5,4,0.5555555555555556,0.4444444444444444,1,1,0.9910760598382222,1
"['11', '100', '1011', '01001']",14,8,6,0.5714285714285714,0.4285714285714285,2,2,0.9852281360342516,1
"['01000', '00', '00011', '1001', '100', '00', '1010100']",28,9,19,0.3214285714285714,0.6785714285714286,2,8,0.9059282160429992,0
"['001', '011']",6,3,3,0.5,0.5,1,1,1.0,1
"['00001', '0000', '101', '001101', '1010000', '000111', '100', '1', '0']",36,13,23,0.3611111111111111,0.6388888888888888,4,9,0.943601631299382,0
"['00100', '010011', '01', '110001', '00010', '011010', '00', '01', '10', '10']",38,15,23,0.3947368421052631,0.6052631578947368,4,8,0.9677884628267678,0
"['011001', '01', '110', '000']",14,6,8,0.4285714285714285,0.5714285714285714,2,3,0.9852281360342516,1
"['111', '000', '11', '100', '101110', '1000', '0100', '0111110', '110']",35,19,16,0.5428571428571428,0.4571428571428571,6,5,0.9946937953613058,0
['0010010'],7,2,5,0.2857142857142857,0.7142857142857143,0,2,0.863120568566631,1
"['0', '10', '001', '01']",8,3,5,0.375,0.625,0,1,0.954434002924965,0
"['0111001', '001', '111101']",16,10,6,0.625,0.375,3,2,0.954434002924965,1
['110'],3,2,1,0.6666666666666666,0.3333333333333333,1,0,0.9182958340544896,1
"['00', '1100100', '00', '0']",12,3,9,0.25,0.75,1,4,0.8112781244591328,0
"['00', '011111', '101010', '0010001']",21,10,11,0.4761904761904761,0.5238095238095238,3,3,0.998363672593813,1
"['011100', '01', '10', '00', '0000']",16,5,11,0.3125,0.6875,2,4,0.8960382325345574,0
"['0', '1110100', '0', '11', '010011', '1000111', '101']",27,15,12,0.5555555555555556,0.4444444444444444,5,3,0.9910760598382222,0
"['0111100', '0100111', '0111', '010010', '010011', '11100', '000']",38,19,19,0.5,0.5,6,7,1.0,1
"['11', '1111101', '01', '11011', '10010', '0000000', '0010010']",35,17,18,0.4857142857142857,0.5142857142857142,5,7,0.9994110647387552,0
"['10100', '1101', '00', '000', '010', '00']",19,6,13,0.3157894736842105,0.6842105263157895,1,5,0.8997437586982626,0
"['1111101', '00000', '110', '1100']",19,10,9,0.5263157894736842,0.4736842105263157,4,3,0.9980008838722996,1
"['0', '00', '0', '0', '00', '100']",10,1,9,0.1,0.9,0,4,0.4689955935892812,0
"['01100', '0101', '0', '0', '1', '110', '0', '00']",18,7,11,0.3888888888888889,0.6111111111111112,2,4,0.964078764808229,0
"['01', '01', '1010', '001111']",14,8,6,0.5714285714285714,0.4285714285714285,3,1,0.9852281360342516,1
"['0', '01', '0', '101']",7,3,4,0.4285714285714285,0.5714285714285714,0,1,0.9852281360342516,0
"['1111011', '1000', '01', '010', '0001', '110', '01', '100']",28,14,14,0.5,0.5,5,6,1.0,0
"['100', '100111', '00', '11001', '0111111']",23,14,9,0.6086956521739131,0.391304347826087,5,4,0.9656361333706098,1
"['11001', '000', '011', '0']",12,5,7,0.4166666666666667,0.5833333333333334,2,3,0.9798687566511528,0
['110'],3,2,1,0.6666666666666666,0.3333333333333333,1,0,0.9182958340544896,1
"['1110001', '11000', '001', '000', '0110110', '1', '11', '1011100']",35,18,17,0.5142857142857142,0.4857142857142857,7,6,0.9994110647387552,0
"['1110', '0110001', '1', '0', '1111110', '001000', '1010000', '11010', '0']",39,19,20,0.4871794871794871,0.5128205128205128,7,7,0.999525689293649,0
"['0101010', '111011']",13,8,5,0.6153846153846154,0.3846153846153846,2,0,0.961236604722876,1
"['111', '0', '110101', '010001', '0', '1', '0100011']",25,13,12,0.52,0.48,3,2,0.9988455359952018,0
"['0111110', '00111', '111', '011011', '1000001']",28,17,11,0.6071428571428571,0.3928571428571428,7,3,0.9666186325481028,1
"['001101', '1000011']",13,6,7,0.4615384615384615,0.5384615384615384,3,3,0.9957274520849256,1
"['00001', '00', '000110', '110001', '11001', '1100010', '01010', '1', '1110101']",44,20,24,0.4545454545454545,0.5454545454545454,6,8,0.9940302114769564,0
"['0011100', '10', '111011', '110', '0000110', '1', '0111', '0001001', '0110', '0000']",45,21,24,0.4666666666666667,0.5333333333333333,7,8,0.9967916319816366,0
['0100'],4,1,3,0.25,0.75,0,1,0.8112781244591328,1
"['10100', '101', '00', '000']",13,4,9,0.3076923076923077,0.6923076923076923,0,3,0.8904916402194913,0
"['1100', '001110', '0', '111000', '0111', '100111', '1010011', '0001111', '11']",43,25,18,0.5813953488372093,0.4186046511627907,11,8,0.9807983646944296,0
"['1100', '1111', '0', '1010001', '11', '100001', '1001111', '1100100', '0111', '00111']",47,27,20,0.574468085106383,0.425531914893617,11,8,0.9839393951635756,0
"['01110', '10010', '100100', '11', '1010']",22,11,11,0.5,0.5,2,3,1.0,1
"['0111', '01', '1011', '10']",12,8,4,0.6666666666666666,0.3333333333333333,3,0,0.9182958340544896,1
"['10011', '11001', '001', '10', '10', '1', '0011101', '01010', '011']",33,18,15,0.5454545454545454,0.4545454545454545,5,5,0.9940302114769564,0
"['1101', '011', '1111', '000', '00']",16,9,7,0.5625,0.4375,4,2,0.9886994082884974,0
"['11', '1110011', '0101010', '11', '01101', '0011']",27,17,10,0.6296296296296297,0.3703703703703703,6,2,0.9509560484549724,1
"['00', '000100', '1110100', '0', '0011110', '001111']",29,13,16,0.4482758620689655,0.5517241379310345,5,6,0.9922666387194964,0
"['10', '111001', '01111', '1011101']",20,14,6,0.7,0.3,4,1,0.8812908992306927,1
"['01010', '000', '0', '11100', '010010']",20,7,13,0.35,0.65,1,4,0.934068055375491,0
"['110001', '1100101', '10011']",18,10,8,0.5555555555555556,0.4444444444444444,4,3,0.9910760598382222,1
"['0110000', '11001', '00', '1']",15,6,9,0.4,0.6,2,4,0.9709505944546686,0
"['010111', '0111100', '100', '11000', '110', '011011']",30,17,13,0.5666666666666667,0.4333333333333333,7,4,0.9871377743721864,1
"['100', '001100', '01101', '00010', '010011', '010110', '10', '0001', '10101', '00']",44,18,26,0.4090909090909091,0.5909090909090909,5,9,0.9760206482366148,0
"['01', '0', '111111']",9,7,2,0.7777777777777778,0.2222222222222222,3,0,0.7642045065086203,1
"['000110', '0010']",10,3,7,0.3,0.7,1,2,0.8812908992306927,1
"['0011110', '001', '11100', '1', '100000', '11001', '0010001']",34,15,19,0.4411764705882353,0.5588235294117647,6,8,0.9899927915575186,0
"['1', '101', '0110001', '01111', '000']",19,10,9,0.5263157894736842,0.4736842105263157,4,2,0.9980008838722996,0
"['0111', '1011', '001', '0001', '10', '110101', '000101', '0000', '10']",35,16,19,0.4571428571428571,0.5428571428571428,5,5,0.9946937953613058,1
"['1', '0', '1100100', '1100100', '1001', '10000', '10101', '01']",32,14,18,0.4375,0.5625,3,7,0.9886994082884974,0
"['11', '101']",5,4,1,0.8,0.2,1,0,0.7219280948873623,1
"['1110', '010', '00001', '01001', '101', '010', '100', '11']",28,13,15,0.4642857142857143,0.5357142857142857,3,5,0.996316519558962,1
"['01101', '001']",8,4,4,0.5,0.5,1,1,1.0,1
"['001101', '0011001', '101', '01111', '11010', '1', '1011110', '1100', '10110']",43,26,17,0.6046511627906976,0.3953488372093023,11,4,0.9681647320759544,0
"['00010', '11111', '110010', '010', '11', '011', '01', '010010', '00010', '10001']",42,20,22,0.4761904761904761,0.5238095238095238,5,7,0.998363672593813,0
"['10', '0', '0010111', '1111', '00001', '000']",22,10,12,0.4545454545454545,0.5454545454545454,3,5,0.9940302114769564,0
"['11', '110110', '01111']",13,10,3,0.7692307692307693,0.2307692307692307,5,1,0.7793498372920851,1
"['00011', '001', '0110110', '0101', '1011', '0001100', '1', '111', '011100']",40,21,19,0.525,0.475,9,6,0.99819587904281,0
"['001', '0', '1', '0110', '1011', '01001', '01111']",23,13,10,0.5652173913043478,0.4347826086956521,4,2,0.9876925088958034,0
"['01', '010101']",8,4,4,0.5,0.5,0,0,1.0,0
"['00', '1', '011', '1101']",10,6,4,0.6,0.4,2,1,0.9709505944546686,0
"['0101', '01011', '111000', '0110', '01', '0111', '11', '10', '01100', '010']",37,20,17,0.5405405405405406,0.4594594594594595,7,5,0.9952525494396792,0
"['101', '101', '0']",7,4,3,0.5714285714285714,0.4285714285714285,1,0,0.9852281360342516,1
"['010110', '010111', '1110']",16,10,6,0.625,0.375,4,1,0.954434002924965,1
"['00010', '11', '10', '01', '001110', '1010111', '11011']",29,17,12,0.5862068965517241,0.4137931034482758,5,3,0.9784493292686188,0
"['1001', '10110', '11', '111', '1001110', '0110001']",28,17,11,0.6071428571428571,0.3928571428571428,7,4,0.9666186325481028,0
"['011001', '001', '1101100', '1111010']",23,13,10,0.5652173913043478,0.4347826086956521,5,3,0.9876925088958034,1
"['101100', '101', '1111', '10011', '00']",20,12,8,0.6,0.4,5,3,0.9709505944546686,1
"['1000100', '00', '1', '0110010', '1100110']",24,10,14,0.4166666666666667,0.5833333333333334,3,5,0.9798687566511528,0
"['1001', '111010', '0']",11,6,5,0.5454545454545454,0.4545454545454545,2,2,0.9940302114769564,1
"['00001', '110111', '0', '1010', '011110', '100010', '101', '1010']",35,18,17,0.5142857142857142,0.4857142857142857,5,4,0.9994110647387552,0
"['00', '11100', '01000', '110', '010011', '0', '1001101', '101']",32,15,17,0.46875,0.53125,5,6,0.9971803988942642,0
"['11', '0011', '010', '1100', '0']",14,7,7,0.5,0.5,3,2,1.0,0
"['1', '10', '11', '010000', '00', '1111', '0100', '11001', '0100', '1111010']",37,19,18,0.5135135135135135,0.4864864864864865,7,6,0.9994730201859836,0
"['1110001', '1']",8,5,3,0.625,0.375,2,1,0.954434002924965,1
"['110100', '011']",9,5,4,0.5555555555555556,0.4444444444444444,2,1,0.9910760598382222,1
"['111101', '0011010', '01', '111101']",21,14,7,0.6666666666666666,0.3333333333333333,5,2,0.9182958340544896,1
"['1010000', '1011100', '00', '00010', '11', '0', '0010', '10111', '110100']",39,17,22,0.4358974358974359,0.5641025641025641,4,7,0.98811083652183,0
"['010', '10', '110011', '000', '0', '1001', '00', '1']",22,9,13,0.4090909090909091,0.5909090909090909,2,5,0.9760206482366148,0
"['0011', '111', '1000', '100101', '0011011', '101101', '0', '01', '0100']",37,19,18,0.5135135135135135,0.4864864864864865,6,6,0.9994730201859836,0
"['1111', '10', '11101', '110', '1', '001011', '01', '101', '0']",27,18,9,0.6666666666666666,0.3333333333333333,6,1,0.9182958340544896,0
"['0110', '1110100', '111001', '00']",19,10,9,0.5263157894736842,0.4736842105263157,3,3,0.9980008838722996,1
"['011011', '0110', '101010', '011', '100011']",25,14,11,0.56,0.44,5,2,0.9895875212220556,0
"['00110', '10011', '011111', '010110', '0', '11100']",28,16,12,0.5714285714285714,0.4285714285714285,6,4,0.9852281360342516,1
"['0101', '011', '0001']",11,5,6,0.4545454545454545,0.5454545454545454,1,1,0.9940302114769564,1
"['1', '00', '00110', '0101', '10000']",17,6,11,0.3529411764705882,0.6470588235294118,2,5,0.9366673818775626,0
"['0', '1011100', '100', '10111', '10', '1000', '10000', '11011', '1101101', '0']",40,21,19,0.525,0.475,7,5,0.99819587904281,0
"['00011', '01111', '0101110']",17,10,7,0.5882352941176471,0.4117647058823529,4,1,0.9774178175281716,1
"['1100100', '01000', '0', '1010', '01011', '01', '0100']",28,11,17,0.3928571428571428,0.6071428571428571,2,6,0.9666186325481028,0
"['011', '11111']",8,7,1,0.875,0.125,3,0,0.5435644431995964,1
"['111', '1']",4,4,0,1.0,0.0,2,0,-0.0,0
"['1000010', '0', '0010', '1100011', '11']",21,9,12,0.4285714285714285,0.5714285714285714,3,5,0.9852281360342516,0
"['00110', '11101', '0001100', '0011', '00', '11110']",28,14,14,0.5,0.5,6,5,1.0,0
"['1010', '1', '10', '1011000', '011', '1111', '10']",23,14,9,0.6086956521739131,0.391304347826087,5,2,0.9656361333706098,0
"['0', '00001', '0110010', '1']",14,5,9,0.3571428571428571,0.6428571428571429,1,3,0.9402859586706313,0
"['0', '011001', '11010', '011010', '0001010', '011', '11', '0', '00']",33,15,18,0.4545454545454545,0.5454545454545454,5,7,0.9940302114769564,0
"['11010', '11101', '0010100', '010', '1010']",24,12,12,0.5,0.5,2,2,1.0,1
"['0100111', '1', '111', '1101111', '0001', '10110']",27,18,9,0.6666666666666666,0.3333333333333333,8,2,0.9182958340544896,0
"['100101', '1111001', '011110']",19,12,7,0.631578947368421,0.3684210526315789,4,2,0.9494520153879484,1
"['0100', '01111', '0110', '0011', '101']",20,11,9,0.55,0.45,4,2,0.9927744539878084,1
"['01110', '01001', '111011', '11010', '0', '101', '000101', '1100110', '100', '011']",44,24,20,0.5454545454545454,0.4545454545454545,8,6,0.9940302114769564,0
"['110000', '00010', '00000', '110001', '001', '00100', '110']",33,10,23,0.303030303030303,0.696969696969697,3,10,0.8849636363831528,0
"['0100110', '1011101', '1111', '0', '00001']",24,13,11,0.5416666666666666,0.4583333333333333,4,3,0.99498482818597,1
"['111001', '1111', '0101', '000', '10', '000110', '1010', '0']",30,15,15,0.5,0.5,4,5,1.0,0
"['01101', '010110', '011', '1', '00100']",20,10,10,0.5,0.5,3,3,1.0,0
"['0000111', '1100011', '1100', '0', '1001']",23,11,12,0.4782608695652174,0.5217391304347826,4,5,0.9986359641585718,0
"['000000', '001', '0010110', '010']",19,5,14,0.2631578947368421,0.7368421052631579,1,6,0.8314743880097293,1
"['1000001', '100010', '110']",16,6,10,0.375,0.625,2,3,0.954434002924965,1
"['01', '0101000', '0110', '1101', '1100', '100010', '11']",29,14,15,0.4827586206896552,0.5172413793103449,4,4,0.9991421039919088,0
"['0000001', '1111']",11,5,6,0.4545454545454545,0.5454545454545454,2,3,0.9940302114769564,1
"['0000001', '100110', '01', '0110101', '0111', '1', '10100', '10', '0']",35,16,19,0.4571428571428571,0.5428571428571428,5,7,0.9946937953613058,0
['0000'],4,0,4,0.0,1.0,0,2,-0.0,1
"['000000', '100', '10', '10111', '1111', '00001']",25,11,14,0.44,0.56,3,6,0.9895875212220556,1
['0011101'],7,4,3,0.5714285714285714,0.4285714285714285,1,1,0.9852281360342516,1
"['1001001', '000100', '110000', '1010111', '01100', '001100', '0', '0110']",42,17,25,0.4047619047619047,0.5952380952380952,5,10,0.97366806454962,0
"['00100', '01011', '1111', '100']",17,9,8,0.5294117647058824,0.4705882352941176,3,3,0.9975025463691152,1
['000'],3,0,3,0.0,1.0,0,1,-0.0,1
"['1110101', '0001101', '111', '10001', '0011']",26,15,11,0.5769230769230769,0.4230769230769231,5,3,0.9828586897127056,1
"['001001', '10', '000', '110100', '1010', '0000011', '100', '100101', '011000', '010011']",49,19,30,0.3877551020408163,0.6122448979591837,5,13,0.963335545672684,0
"['001', '01', '1', '10', '010', '0', '0']",13,5,8,0.3846153846153846,0.6153846153846154,1,3,0.961236604722876,0
"['0010010', '1', '00', '0110', '01111']",19,9,10,0.4736842105263157,0.5263157894736842,3,4,0.9980008838722996,0
"['10', '000010', '1100', '00', '10']",16,5,11,0.3125,0.6875,1,4,0.8960382325345574,0
['11'],2,2,0,1.0,0.0,1,0,-0.0,1
"['0001001', '00000', '011', '110000', '00111', '00', '1110001', '000', '011011']",44,17,27,0.3863636363636363,0.6136363636363636,6,12,0.9624127354629924,0
"['10111', '1001', '1110010', '10000', '1001100', '10100', '10001', '0000100', '010', '0111110']",55,25,30,0.4545454545454545,0.5454545454545454,7,12,0.9940302114769564,1
['0'],1,0,1,0.0,1.0,0,0,-0.0,1
"['0111011', '00010', '01']",14,7,7,0.5,0.5,2,2,1.0,1
"['101', '0000', '1', '01011', '11', '11', '01101']",22,13,9,0.5909090909090909,0.4090909090909091,4,2,0.9760206482366148,0
"['00', '1111', '111', '1', '1100110']",17,12,5,0.7058823529411765,0.2941176470588235,6,2,0.8739810481273578,0
"['1', '1011', '1001011', '0110110', '111', '0101101', '00', '0101111', '0', '11010']",44,27,17,0.6136363636363636,0.3863636363636363,10,2,0.9624127354629924,0
"['00', '1111111', '11001', '0', '000', '1100000']",25,12,13,0.48,0.52,5,6,0.9988455359952018,0
"['0', '1110', '10100', '1000100', '111']",20,10,10,0.5,0.5,2,3,1.0,0
"['1', '1', '11']",4,4,0,1.0,0.0,2,0,-0.0,0
"['010010', '01', '1101', '01110', '010', '010']",23,11,12,0.4782608695652174,0.5217391304347826,2,4,0.9986359641585718,0
"['0100', '0101', '000000', '10', '011', '0', '0101', '11', '0000001']",33,11,22,0.3333333333333333,0.6666666666666666,2,9,0.9182958340544896,0
"['11', '0', '01000', '011', '11', '01', '00', '1111011']",24,14,10,0.5833333333333334,0.4166666666666667,6,4,0.9798687566511528,0
"['000', '01110']",8,3,5,0.375,0.625,1,2,0.954434002924965,1
"['1', '1', '100', '11', '000101']",13,7,6,0.5384615384615384,0.4615384615384615,2,2,0.9957274520849256,0
"['0101110', '1001', '11001', '0100110', '111111', '0', '10100', '1']",36,21,15,0.5833333333333334,0.4166666666666667,6,4,0.9798687566511528,0
"['0', '000000', '111', '11', '01010', '10', '111101', '000', '0001101', '0010']",39,17,22,0.4358974358974359,0.5641025641025641,5,7,0.98811083652183,0
"['11', '1']",3,3,0,1.0,0.0,1,0,-0.0,0
"['1010', '10110']",9,5,4,0.5555555555555556,0.4444444444444444,1,0,0.9910760598382222,1
"['10', '0100000', '1', '1000']",14,4,10,0.2857142857142857,0.7142857142857143,1,4,0.863120568566631,1
"['1', '0111001']",8,5,3,0.625,0.375,1,1,0.954434002924965,1
"['0010101', '10001', '1000011', '10110', '1110', '0111010', '1', '10', '01']",40,21,19,0.525,0.475,7,6,0.99819587904281,0
"['0011000', '10', '10', '01100', '01', '101', '1', '0', '01100']",28,12,16,0.4285714285714285,0.5714285714285714,5,6,0.9852281360342516,0
"['101010', '101111', '0111', '1010', '010', '001', '10011', '0000111']",38,21,17,0.5526315789473685,0.4473684210526316,7,5,0.9919924034538556,0
"['10001', '1110', '01111', '00000', '11001', '110010', '0', '0']",32,15,17,0.46875,0.53125,6,7,0.9971803988942642,0
"['00011', '1001']",9,4,5,0.4444444444444444,0.5555555555555556,1,2,0.9910760598382222,1
"['0001', '0000', '000000', '011000', '1', '011', '1000100', '0110']",35,10,25,0.2857142857142857,0.7142857142857143,3,9,0.863120568566631,0
"['00101', '1101110', '111110', '1101', '0100010', '0', '11110', '1001100', '00', '010010']",50,26,24,0.52,0.48,8,7,0.9988455359952018,0
"['1111', '0101000', '01', '011']",16,9,7,0.5625,0.4375,3,2,0.9886994082884974,1
"['11100', '11011', '0100', '11', '010', '101011']",25,15,10,0.6,0.4,5,2,0.9709505944546686,1
"['01010', '0100010', '010000', '110110']",24,9,15,0.375,0.625,2,5,0.954434002924965,1
"['011', '11011', '0', '1001', '101011', '011000', '11111', '0101001', '00']",39,22,17,0.5641025641025641,0.4358974358974359,8,4,0.98811083652183,0
['0011100'],7,3,4,0.4285714285714285,0.5714285714285714,1,2,0.9852281360342516,1
"['01000', '01011', '110']",13,6,7,0.4615384615384615,0.5384615384615384,2,2,0.9957274520849256,1
"['1001', '1']",5,3,2,0.6,0.4,1,1,0.9709505944546686,1
"['10', '101']",5,3,2,0.6,0.4,0,0,0.9709505944546686,1
"['0010', '10110']",9,4,5,0.4444444444444444,0.5555555555555556,1,1,0.9910760598382222,1
"['01001', '00', '010000', '111100', '0100110', '0', '100100', '011']",36,14,22,0.3888888888888889,0.6111111111111112,4,9,0.964078764808229,0
"['111', '010', '11001', '0101', '000010', '100']",24,11,13,0.4583333333333333,0.5416666666666666,2,4,0.99498482818597,1
"['11', '00001', '1010110', '1', '01', '010', '1011001', '11100']",32,17,15,0.53125,0.46875,6,4,0.9971803988942642,0
['0'],1,0,1,0.0,1.0,0,0,-0.0,1
"['0110000', '101', '11111', '0111110', '1000110', '1']",30,18,12,0.6,0.4,7,3,0.9709505944546686,0
['010'],3,1,2,0.3333333333333333,0.6666666666666666,0,0,0.9182958340544896,1
"['10', '1100', '101']",9,5,4,0.5555555555555556,0.4444444444444444,1,1,0.9910760598382222,1
"['00000', '0100100', '01000', '0', '1101100', '01', '1010111', '000101', '00111']",45,18,27,0.4,0.6,5,10,0.9709505944546686,0
"['011', '010', '001', '11000']",14,6,8,0.4285714285714285,0.5714285714285714,2,2,0.9852281360342516,1
"['110', '0000', '010', '10', '10010', '1101000', '011111', '0000001']",37,15,22,0.4054054054054054,0.5945945945945946,4,9,0.974024864435752,0
"['10', '11', '0', '001']",8,4,4,0.5,0.5,1,1,1.0,0
"['1111110', '00111', '1001100', '1001010', '00']",28,15,13,0.5357142857142857,0.4642857142857143,6,5,0.996316519558962,1
"['010', '1100', '1010101', '111000', '1100100', '0111', '1', '10101', '0110']",41,22,19,0.5365853658536586,0.4634146341463415,7,4,0.9961344835095796,0
"['00101', '0', '11', '1']",9,5,4,0.5555555555555556,0.4444444444444444,1,1,0.9910760598382222,0
"['1011', '0110101', '00001', '1010011', '11010', '1111111', '101010', '00001', '0011', '111000']",56,31,25,0.5535714285714286,0.4464285714285714,11,7,0.9917033083725818,1
"['101100', '0110', '111011', '1', '101', '1011000']",27,16,11,0.5925925925925926,0.4074074074074074,7,2,0.975119064940866,0
"['1001011', '1011110', '10010', '1']",20,12,8,0.6,0.4,3,2,0.9709505944546686,0
"['1100', '11110', '01', '1101', '1100101', '1000101', '101011', '00', '0', '010001']",44,23,21,0.5227272727272727,0.4772727272727273,8,7,0.9985090989176322,0
"['0001', '1', '0000000', '1001110', '00']",21,6,15,0.2857142857142857,0.7142857142857143,2,6,0.863120568566631,0
"['001', '10100', '01', '00']",12,4,8,0.3333333333333333,0.6666666666666666,1,3,0.9182958340544896,0
"['001', '1010010', '010', '1100011', '10', '00', '0', '110100', '0010000', '1']",39,15,24,0.3846153846153846,0.6153846153846154,4,10,0.961236604722876,0
"['0011010', '11', '111111', '010']",18,12,6,0.6666666666666666,0.3333333333333333,5,1,0.9182958340544896,0
"['101', '111100', '1100100', '101101', '0', '00', '1111', '0']",30,17,13,0.5666666666666667,0.4333333333333333,6,4,0.9871377743721864,0
"['00110', '0', '0000000', '01', '010001']",21,5,16,0.238095238095238,0.7619047619047619,1,7,0.7918583525674836,0
"['110', '0000', '01', '01111', '11', '101', '11100']",24,14,10,0.5833333333333334,0.4166666666666667,6,4,0.9798687566511528,0
"['101', '0', '01000', '101101', '00', '10', '0011111', '1']",27,14,13,0.5185185185185185,0.4814814814814814,4,4,0.9990102708804812,0
"['10', '1000', '1000', '1', '00011', '10111', '10100', '1001']",30,14,16,0.4666666666666667,0.5333333333333333,3,5,0.9967916319816366,0
"['0110', '0100111', '110', '01', '100']",19,10,9,0.5263157894736842,0.4736842105263157,4,4,0.9980008838722996,0
"['110110', '1011010']",13,8,5,0.6153846153846154,0.3846153846153846,3,0,0.961236604722876,1
"['1', '0', '111', '10101']",10,7,3,0.7,0.3,2,0,0.8812908992306927,0
"['1110010', '00100', '101011', '0001', '0110', '11', '00']",30,14,16,0.4666666666666667,0.5333333333333333,4,5,0.9967916319816366,1
"['011', '00110']",8,4,4,0.5,0.5,2,1,1.0,1
['010'],3,1,2,0.3333333333333333,0.6666666666666666,0,0,0.9182958340544896,1
"['0010', '11', '00', '01110', '0001', '01', '01', '0011010']",28,12,16,0.4285714285714285,0.5714285714285714,3,5,0.9852281360342516,0
"['10110', '0', '1']",7,4,3,0.5714285714285714,0.4285714285714285,1,1,0.9852281360342516,0
"['011001', '0', '0', '10100', '000001', '0', '0', '1011111']",28,12,16,0.4285714285714285,0.5714285714285714,3,6,0.9852281360342516,1
"['010', '00001', '0', '1', '00', '1001101', '0000', '0']",24,7,17,0.2916666666666667,0.7083333333333334,1,6,0.8708644692353644,0
"['00111', '1101', '0100110', '001101', '110101']",28,16,12,0.5714285714285714,0.4285714285714285,5,3,0.9852281360342516,1
"['0100100', '0']",8,2,6,0.25,0.75,0,2,0.8112781244591328,1
"['01', '1', '1', '111']",7,6,1,0.8571428571428571,0.1428571428571428,3,0,0.5916727785823275,0
"['00010', '1']",6,2,4,0.3333333333333333,0.6666666666666666,0,1,0.9182958340544896,1
"['000', '00', '11']",7,2,5,0.2857142857142857,0.7142857142857143,1,2,0.863120568566631,0
"['01111', '1', '11110', '10', '00', '00', '111']",20,13,7,0.65,0.35,5,2,0.934068055375491,0
"['1110', '10011', '10100', '01001', '00100', '1', '1']",26,13,13,0.5,0.5,3,5,1.0,0
['01'],2,1,1,0.5,0.5,0,0,1.0,1
"['100', '110', '0100110', '100']",16,7,9,0.4375,0.5625,2,4,0.9886994082884974,1
"['0', '111', '101011', '0010011', '1', '0001100', '100000', '111', '00']",36,17,19,0.4722222222222222,0.5277777777777778,6,7,0.997772472089982,0
"['0010', '10', '1', '0011010', '11010', '0', '011111', '01']",28,15,13,0.5357142857142857,0.4642857142857143,4,3,0.996316519558962,0
"['1', '11111', '0', '1000', '1010101']",18,11,7,0.6111111111111112,0.3888888888888889,3,1,0.964078764808229,0
"['1100000', '10011', '10010', '00', '0010001', '111', '111']",32,15,17,0.46875,0.53125,5,7,0.9971803988942642,1
"['1100011', '11010', '01000', '11', '001101']",25,13,12,0.52,0.48,5,4,0.9988455359952018,1
"['01', '00', '10', '011111', '011110', '010101', '0001011', '1', '10100', '01']",39,21,18,0.5384615384615384,0.4615384615384615,6,5,0.9957274520849256,0
"['1000111', '00010']",12,5,7,0.4166666666666667,0.5833333333333334,1,2,0.9798687566511528,1
['011'],3,2,1,0.6666666666666666,0.3333333333333333,1,0,0.9182958340544896,1
"['0011000', '0110', '1010111', '011', '00', '01011', '0', '111', '11', '1']",35,20,15,0.5714285714285714,0.4285714285714285,8,4,0.9852281360342516,0
"['100', '1100011', '010']",13,6,7,0.4615384615384615,0.5384615384615384,2,2,0.9957274520849256,1
"['0101110', '100001', '11111']",18,11,7,0.6111111111111112,0.3888888888888889,4,2,0.964078764808229,1
"['010', '001', '01', '10111', '110001', '1000', '1100100']",30,14,16,0.4666666666666667,0.5333333333333333,5,5,0.9967916319816366,0
['000'],3,0,3,0.0,1.0,0,1,-0.0,1
"['11', '00110', '1', '1110', '000', '111110', '11001', '110111', '0000010']",39,22,17,0.5641025641025641,0.4358974358974359,9,6,0.98811083652183,0
['1'],1,1,0,1.0,0.0,0,0,-0.0,1
"['1010110', '10', '1', '100010', '010']",19,9,10,0.4736842105263157,0.5263157894736842,2,2,0.9980008838722996,0
"['1', '000111', '0001100', '1', '001010', '0']",22,9,13,0.4090909090909091,0.5909090909090909,2,5,0.9760206482366148,0
"['0111', '11', '00', '00101', '01', '110000', '100000']",27,11,16,0.4074074074074074,0.5925925925925926,3,6,0.975119064940866,0
"['1010', '0011']",8,4,4,0.5,0.5,1,1,1.0,1
"['0', '00', '010']",6,1,5,0.1666666666666666,0.8333333333333334,0,2,0.6500224216483541,0
['001'],3,1,2,0.3333333333333333,0.6666666666666666,0,1,0.9182958340544896,1
"['00000', '1110', '111101']",15,8,7,0.5333333333333333,0.4666666666666667,3,2,0.9967916319816366,1
"['11', '1', '001000', '0011']",13,6,7,0.4615384615384615,0.5384615384615384,2,3,0.9957274520849256,0
"['01111', '10', '10', '010', '1100011', '1', '110']",23,14,9,0.6086956521739131,0.391304347826087,5,2,0.9656361333706098,0
"['0010', '1110101', '01', '1101000', '10010', '1000', '0111', '1000100', '1101011']",47,23,24,0.4893617021276595,0.5106382978723404,6,7,0.9996734260048916,0
"['000', '001110']",9,3,6,0.3333333333333333,0.6666666666666666,1,2,0.9182958340544896,1
"['1110', '1100', '01', '0000', '000', '11100', '00']",24,9,15,0.375,0.625,3,6,0.954434002924965,0
"['0', '00001', '1', '0000111', '1100', '01000', '111', '01', '1100101', '0000001']",42,17,25,0.4047619047619047,0.5952380952380952,5,10,0.97366806454962,0
"['110101', '10']",8,5,3,0.625,0.375,2,0,0.954434002924965,1
"['110110', '000', '1', '010111']",16,9,7,0.5625,0.4375,3,2,0.9886994082884974,1
"['11011', '0000', '0111010']",16,8,8,0.5,0.5,3,2,1.0,1
"['10', '0', '1010', '101000', '111']",16,8,8,0.5,0.5,1,2,1.0,0
"['10', '0', '00', '000010', '000', '01']",16,3,13,0.1875,0.8125,0,6,0.6962122601251458,0
"['010', '0', '0']",5,1,4,0.2,0.8,0,1,0.7219280948873623,1
"['011', '0001111', '000', '111011', '11', '100', '0', '1']",26,15,11,0.5769230769230769,0.4230769230769231,6,3,0.9828586897127056,0
"['01', '00110']",7,3,4,0.4285714285714285,0.5714285714285714,1,1,0.9852281360342516,1
['0'],1,0,1,0.0,1.0,0,0,-0.0,1
"['100', '11110', '0111', '10111', '10', '1101', '110001']",29,19,10,0.6551724137931034,0.3448275862068966,8,3,0.9293636260137188,0
"['001', '000101', '1000010', '0100010', '11100', '111000', '1111001', '0000']",45,18,27,0.4,0.6,5,11,0.9709505944546686,1
"['0011', '0110111', '0']",12,7,5,0.5833333333333334,0.4166666666666667,3,1,0.9798687566511528,1
"['11110', '110010', '000', '1110']",18,10,8,0.5555555555555556,0.4444444444444444,4,3,0.9910760598382222,1
"['0111111', '11', '0000010']",16,9,7,0.5625,0.4375,4,2,0.9886994082884974,1
"['01101', '11011', '1', '01']",13,9,4,0.6923076923076923,0.3076923076923077,3,0,0.8904916402194913,0
"['101011', '0', '1', '0000101']",15,7,8,0.4666666666666667,0.5333333333333333,1,2,0.9967916319816366,0
"['00', '010100', '010011', '0', '11', '1', '101000']",24,10,14,0.4166666666666667,0.5833333333333334,3,4,0.9798687566511528,0
"['0', '10', '10', '0', '01111', '010110', '0100', '111011', '11', '101101']",35,21,14,0.6,0.4,7,3,0.9709505944546686,0
"['11111', '01', '01101']",12,9,3,0.75,0.25,3,0,0.8112781244591328,1
"['00', '001001', '10001']",13,4,9,0.3076923076923077,0.6923076923076923,1,4,0.8904916402194913,1
"['101', '0', '110', '0110', '1', '0111110', '0', '111101', '11011']",31,21,10,0.6774193548387096,0.3225806451612903,8,2,0.907165767573082,0
['101001'],6,3,3,0.5,0.5,0,1,1.0,1
"['1001000', '10000', '100001', '10001', '1', '1000', '011001', '010011']",40,15,25,0.375,0.625,4,11,0.954434002924965,0
"['101000', '01', '1', '01100', '0110', '1111', '001001']",28,14,14,0.5,0.5,5,5,1.0,0
['010'],3,1,2,0.3333333333333333,0.6666666666666666,0,0,0.9182958340544896,1
"['10', '00000']",7,1,6,0.1428571428571428,0.8571428571428571,0,3,0.5916727785823275,1
"['11', '1101100', '1101110', '01101', '0001', '0', '0100010', '0101100']",40,20,20,0.5,0.5,7,7,1.0,0
"['011', '0', '011']",7,4,3,0.5714285714285714,0.4285714285714285,2,1,0.9852281360342516,1
['01'],2,1,1,0.5,0.5,0,0,1.0,1
"['1011011', '0100', '1111101', '110001', '1', '101', '1', '01', '1000001', '1']",39,23,16,0.5897435897435898,0.4102564102564102,9,4,0.97663491144401,0
"['110', '1', '1001', '1101', '110', '101']",18,12,6,0.6666666666666666,0.3333333333333333,4,1,0.9182958340544896,0
"['101', '10000', '1001110', '101', '1000111', '1', '111', '1']",30,18,12,0.6,0.4,7,4,0.9709505944546686,0
"['0', '1011011', '0111', '1', '110001', '1001', '0', '0000', '100001']",34,16,18,0.4705882352941176,0.5294117647058824,6,6,0.9975025463691152,0
"['0', '111101', '1', '1001100', '1110011', '1', '001111', '0101001', '0011', '1100000']",47,26,21,0.5531914893617021,0.4468085106382978,10,8,0.9918207974218424,0
"['110100', '101001', '1001', '0101110', '01010', '11011', '010', '10', '1100', '000']",45,22,23,0.4888888888888889,0.5111111111111111,6,6,0.999643749677856,0
"['11100', '00']",7,3,4,0.4285714285714285,0.5714285714285714,1,2,0.9852281360342516,1
"['001010', '0', '100010', '00111', '01101', '111000', '00', '001111']",37,17,20,0.4594594594594595,0.5405405405405406,6,7,0.9952525494396792,0
"['11111', '0', '00', '1110011', '11111', '0110010', '00000', '11011']",37,22,15,0.5945945945945946,0.4054054054054054,9,6,0.974024864435752,0
"['0011', '011111', '011011', '011', '01', '1110', '111001', '0101', '010', '1001']",42,26,16,0.6190476190476191,0.3809523809523809,9,3,0.9587118829771318,0
['0'],1,0,1,0.0,1.0,0,0,-0.0,1
"['00', '1', '00010']",8,2,6,0.25,0.75,0,2,0.8112781244591328,1
"['00', '01010', '0', '01000', '111', '111010', '00001']",27,11,16,0.4074074074074074,0.5925925925925926,3,5,0.975119064940866,0
"['1011111', '111', '1100']",14,11,3,0.7857142857142857,0.2142857142857142,5,1,0.74959525725948,1
"['101', '101100', '11000', '0110111', '1000', '11111', '10', '011111', '11001']",43,27,16,0.627906976744186,0.3720930232558139,12,6,0.9522656254366642,0
"['1110000', '0111', '1010111', '01', '001011', '0010101', '0']",34,18,16,0.5294117647058824,0.4705882352941176,5,4,0.9975025463691152,0
"['0', '1010', '100000', '0011', '0', '00']",18,5,13,0.2777777777777778,0.7222222222222222,1,4,0.8524051786494786,0
"['10101', '1', '1011', '1001100']",17,10,7,0.5882352941176471,0.4117647058823529,3,2,0.9774178175281716,1
"['110', '111110', '101', '11110', '00100', '1010', '00010']",31,17,14,0.5483870967741935,0.4516129032258064,5,4,0.9932338197397066,1
"['1100000', '1000']",11,3,8,0.2727272727272727,0.7272727272727273,1,3,0.8453509366224364,1
['0100'],4,1,3,0.25,0.75,0,1,0.8112781244591328,1
"['110110', '00', '11', '01100']",15,8,7,0.5333333333333333,0.4666666666666667,4,2,0.9967916319816366,0
['1011100'],7,4,3,0.5714285714285714,0.4285714285714285,1,1,0.9852281360342516,1
"['0100101', '1100', '11']",13,7,6,0.5384615384615384,0.4615384615384615,2,2,0.9957274520849256,1
"['1100', '1011000', '1101001', '11', '011', '10', '0000', '0', '10100', '01110']",40,19,21,0.475,0.525,6,7,0.99819587904281,0
"['1000', '1100001', '01', '0000110', '10', '1010110', '1', '101', '110']",36,17,19,0.4722222222222222,0.5277777777777778,5,5,0.997772472089982,0
"['1', '011', '011000', '01101', '1111100', '0111', '011', '000']",32,18,14,0.5625,0.4375,8,4,0.9886994082884974,0
"['00100', '10001', '11001', '0001', '010', '00', '000']",27,8,19,0.2962962962962963,0.7037037037037037,1,8,0.876716288999464,0
['0'],1,0,1,0.0,1.0,0,0,-0.0,1
"['00111', '1000010']",12,5,7,0.4166666666666667,0.5833333333333334,2,3,0.9798687566511528,1
"['01111', '0101']",9,6,3,0.6666666666666666,0.3333333333333333,2,0,0.9182958340544896,1
"['011001', '11']",8,5,3,0.625,0.375,2,1,0.954434002924965,1
"['010', '1', '1011', '1', '0110', '101011', '010000', '1011001']",32,17,15,0.53125,0.46875,5,3,0.9971803988942642,0
"['0000', '010', '010', '000001', '110', '111001', '11011', '0111', '0']",35,16,19,0.4571428571428571,0.5428571428571428,5,7,0.9946937953613058,0
"['111110', '00', '010', '101000', '000100']",23,9,14,0.391304347826087,0.6086956521739131,2,6,0.9656361333706098,1
"['1', '0', '0111', '0000']",10,4,6,0.4,0.6,1,3,0.9709505944546686,0
"['0110', '1101', '011', '0', '1', '0111100', '0', '1011100', '00101']",33,18,15,0.5454545454545454,0.4545454545454545,6,3,0.9940302114769564,0
"['0111101', '111', '100', '101101', '110', '110', '010', '011101', '010011']",40,25,15,0.625,0.375,9,4,0.954434002924965,1
"['00', '10', '00011']",9,3,6,0.3333333333333333,0.6666666666666666,1,3,0.9182958340544896,1
"['1', '0', '101111', '01', '1110010', '0', '01']",20,12,8,0.6,0.4,4,2,0.9709505944546686,0
"['1101', '0000110', '101', '11', '10']",18,10,8,0.5555555555555556,0.4444444444444444,4,2,0.9910760598382222,0
"['0000', '11111', '00', '1001001', '0101011']",25,12,13,0.48,0.52,3,5,0.9988455359952018,0
"['1111101', '11', '101101', '10']",17,13,4,0.7647058823529411,0.2352941176470588,6,0,0.7871265862012691,1
"['0000101', '010', '10111', '1', '00', '00001']",23,9,14,0.391304347826087,0.6086956521739131,2,5,0.9656361333706098,0
"['01000', '001', '00', '1', '1', '000001', '010']",21,6,15,0.2857142857142857,0.7142857142857143,1,5,0.863120568566631,0
"['1011000', '101010', '00011', '0101010', '0100000', '00', '0101111', '10', '01000', '0011']",52,21,31,0.4038461538461538,0.5961538461538461,5,11,0.9731560354421096,0
"['0111', '00', '0100001', '01101', '0', '00', '1', '01', '10100', '0101']",33,14,19,0.4242424242424242,0.5757575757575758,3,5,0.9833761901392236,0
"['10', '1', '100000']",9,3,6,0.3333333333333333,0.6666666666666666,1,2,0.9182958340544896,1
"['01001', '0', '0110', '0']",11,4,7,0.3636363636363636,0.6363636363636364,1,3,0.94566030460064,1
"['110', '101100', '00', '101001', '100']",20,9,11,0.45,0.55,3,4,0.9927744539878084,1
"['00', '01001', '0011111']",14,7,7,0.5,0.5,2,3,1.0,1
['0001111'],7,4,3,0.5714285714285714,0.4285714285714285,2,1,0.9852281360342516,1
"['0', '00', '0000', '0', '1001', '1101', '0010', '1110']",24,9,15,0.375,0.625,2,6,0.954434002924965,0
"['0', '0010010']",8,2,6,0.25,0.75,0,2,0.8112781244591328,1
"['11010', '0110', '1110000']",16,8,8,0.5,0.5,3,3,1.0,1
"['1110011', '1111', '110010', '01001', '0011', '0110', '0000', '1100', '00']",40,20,20,0.5,0.5,8,9,1.0,0
['001'],3,1,2,0.3333333333333333,0.6666666666666666,0,1,0.9182958340544896,1
"['110001', '0111000', '01', '11100', '1000000', '1111000', '10110']",39,18,21,0.4615384615384615,0.5384615384615384,7,8,0.9957274520849256,0
"['10001', '0', '10011']",11,5,6,0.4545454545454545,0.5454545454545454,1,2,0.9940302114769564,1
"['11', '010001', '110010']",14,7,7,0.5,0.5,2,2,1.0,1
"['1', '100', '0', '0', '011', '000', '000', '1', '1001001', '11101']",28,12,16,0.4285714285714285,0.5714285714285714,5,7,0.9852281360342516,0
"['001101', '111', '1111110', '1011101', '1111001', '000', '1']",34,23,11,0.6764705882352942,0.3235294117647059,9,3,0.9081783472997051,0
"['1100', '10', '11001', '1011', '0111', '11100', '0', '0000010', '1001111']",39,21,18,0.5384615384615384,0.4615384615384615,9,7,0.9957274520849256,0
"['011010', '0000', '00', '0011', '100000', '0', '00101', '001']",31,9,22,0.2903225806451613,0.7096774193548387,2,9,0.869137580612638,0
"['1111', '00000', '0']",10,4,6,0.4,0.6,2,3,0.9709505944546686,0
"['101', '0011010', '1111']",14,9,5,0.6428571428571429,0.3571428571428571,3,1,0.9402859586706313,1
"['00010', '1111110', '00001', '1000011', '001', '10111', '1010110', '1', '1101', '1110']",48,27,21,0.5625,0.4375,12,6,0.9886994082884974,0
"['101', '101101', '0010', '0100']",17,8,9,0.4705882352941176,0.5294117647058824,2,3,0.9975025463691152,0
"['01111', '000', '1011001', '00', '10100', '01', '0', '100010', '1101', '00000']",40,16,24,0.4,0.6,4,7,0.9709505944546686,0
"['11000', '111001', '011', '00101', '0110', '1', '0100101', '001101', '00', '010']",42,20,22,0.4761904761904761,0.5238095238095238,5,6,0.998363672593813,0
['0000000'],7,0,7,0.0,1.0,0,3,-0.0,1
"['111', '1110', '10111', '01', '00110', '111010', '0', '111100']",32,21,11,0.65625,0.34375,8,3,0.9283620723948676,0
"['1110110', '0011011']",14,9,5,0.6428571428571429,0.3571428571428571,4,1,0.9402859586706313,1
"['000', '01', '11']",7,3,4,0.4285714285714285,0.5714285714285714,1,2,0.9852281360342516,1
"['10101', '11', '1110']",11,8,3,0.7272727272727273,0.2727272727272727,3,0,0.8453509366224364,1
"['011110', '111101', '011100', '1011100', '010', '0', '1', '1010110', '101']",40,24,16,0.6,0.4,8,3,0.9709505944546686,0
"['000', '100', '0000']",10,1,9,0.1,0.9,0,4,0.4689955935892812,0
"['0', '100', '0', '0001010']",12,3,9,0.25,0.75,0,3,0.8112781244591328,1
"['1011', '0', '1', '0101011', '010011', '0110', '0010101', '0', '1', '11']",34,19,15,0.5588235294117647,0.4411764705882353,5,2,0.9899927915575186,0
"['0000', '110011', '0100000', '1010']",21,7,14,0.3333333333333333,0.6666666666666666,2,5,0.9182958340544896,1
"['11', '10111', '0001001', '10111', '100100', '1']",26,15,11,0.5769230769230769,0.4230769230769231,5,4,0.9828586897127056,0
"['1000', '10', '00', '100', '0000', '01', '0100']",21,5,16,0.238095238095238,0.7619047619047619,0,6,0.7918583525674836,0
"['1', '010111', '111']",10,8,2,0.8,0.2,3,0,0.7219280948873623,0
"['10', '00', '1', '0110000', '1', '01', '10', '0', '1001001', '11100']",30,13,17,0.4333333333333333,0.5666666666666667,4,7,0.9871377743721864,0
"['0011', '111', '01', '110', '10', '011', '0110011', '0']",25,15,10,0.6,0.4,6,3,0.9709505944546686,0
"['0', '0']",2,0,2,0.0,1.0,0,1,-0.0,1
['01'],2,1,1,0.5,0.5,0,0,1.0,1
"['1', '10001', '10000', '0110100']",18,7,11,0.3888888888888889,0.6111111111111112,3,4,0.964078764808229,1
"['10011', '1101000', '0010']",16,7,9,0.4375,0.5625,2,3,0.9886994082884974,1
"['0010101', '010']",10,4,6,0.4,0.6,0,1,0.9709505944546686,1
"['00011', '1', '1', '0110', '1000011', '01101', '01', '1']",26,14,12,0.5384615384615384,0.4615384615384615,6,3,0.9957274520849256,0
"['1010', '11101', '0001011', '1110010', '11100', '1011', '11110', '00']",39,23,16,0.5897435897435898,0.4102564102564102,7,4,0.97663491144401,0
"['001', '00001', '000', '1010110', '0', '000', '101', '110', '1001101', '100100']",41,16,25,0.3902439024390244,0.6097560975609756,4,9,0.9649567669505684,0
"['11', '100', '111', '001100', '1010111', '1111', '000101', '010']",34,20,14,0.5882352941176471,0.4117647058823529,6,4,0.9774178175281716,0
"['101', '0', '10', '00001', '010', '00', '1001011', '101', '1']",27,12,15,0.4444444444444444,0.5555555555555556,2,4,0.9910760598382222,0
"['1', '11011', '0000']",10,5,5,0.5,0.5,2,2,1.0,1
"['00', '10', '001', '101111']",13,7,6,0.5384615384615384,0.4615384615384615,3,2,0.9957274520849256,1
"['1', '1001000', '1010', '110111', '10']",20,11,9,0.55,0.45,4,2,0.9927744539878084,0
"['11', '0010011', '00110', '011', '10']",19,10,9,0.5263157894736842,0.4736842105263157,4,4,0.9980008838722996,1
"['010011', '01', '110', '0001', '01', '0110000', '11']",26,12,14,0.4615384615384615,0.5384615384615384,4,5,0.9957274520849256,1
['01010'],5,2,3,0.4,0.6,0,0,0.9709505944546686,1
"['1', '101101', '011', '011', '0', '00000', '0110000', '01100', '10']",33,14,19,0.4242424242424242,0.5757575757575758,6,6,0.9833761901392236,0
"['10111', '1011000', '1', '0', '0010110', '0110110', '011101', '1110', '101', '0']",42,24,18,0.5714285714285714,0.4285714285714285,9,4,0.9852281360342516,0
"['011', '0001000', '1', '11101', '01110', '1', '100', '11100', '11110', '110']",38,22,16,0.5789473684210527,0.4210526315789473,9,4,0.9819407868640976,0
"['0100010', '000111', '0100', '011', '00100']",25,9,16,0.36,0.64,2,6,0.9426831892554922,0
"['011010', '101']",9,5,4,0.5555555555555556,0.4444444444444444,1,0,0.9910760598382222,1
"['011', '0', '1001011', '1', '11000', '100100', '0110', '1']",28,14,14,0.5,0.5,4,4,1.0,0
"['0', '01110', '01100', '1011', '1100000']",22,10,12,0.4545454545454545,0.5454545454545454,4,5,0.9940302114769564,0
"['0001101', '1101', '01100', '01', '1010', '000', '01100', '01', '10']",34,15,19,0.4411764705882353,0.5588235294117647,6,5,0.9899927915575186,0
"['0010110', '00', '0']",10,3,7,0.3,0.7,1,3,0.8812908992306927,0
"['11', '00000', '101000', '11', '1', '1101001']",23,11,12,0.4782608695652174,0.5217391304347826,3,4,0.9986359641585718,0
"['01110', '0100', '001111', '10010', '001000', '0110000']",33,13,20,0.3939393939393939,0.6060606060606061,4,9,0.9672947789468944,1
"['0110', '0111000', '01000']",16,6,10,0.375,0.625,2,4,0.954434002924965,1
"['0010000', '01111', '1', '0111', '00', '111', '1111110', '0101010']",36,21,15,0.5833333333333334,0.4166666666666667,7,5,0.9798687566511528,0
"['1101000', '000', '0001010', '0001', '00']",23,6,17,0.2608695652173913,0.7391304347826086,1,7,0.828055725379504,0
"['00', '111', '101', '000011', '01', '000', '0101000', '1']",27,11,16,0.4074074074074074,0.5925925925925926,3,6,0.975119064940866,0
"['000111', '11010', '1010111', '000010', '111010']",30,16,14,0.5333333333333333,0.4666666666666667,4,3,0.9967916319816366,1
"['00', '1', '0', '01', '010', '1101']",13,6,7,0.4615384615384615,0.5384615384615384,1,2,0.9957274520849256,0
"['1101010', '10000', '1', '1', '110001', '0111', '1110', '0010', '1111000', '011']",42,23,19,0.5476190476190477,0.4523809523809524,9,6,0.9934472383802028,0
"['000', '0111101', '0100010', '001110']",23,10,13,0.4347826086956521,0.5652173913043478,3,4,0.9876925088958034,1
"['0001111', '1101100', '0110100', '0100']",25,12,13,0.48,0.52,5,4,0.9988455359952018,1
"['1000', '0111']",8,4,4,0.5,0.5,1,2,1.0,1
"['0', '0010', '00001', '0', '100', '1000011', '0', '0']",23,6,17,0.2608695652173913,0.7391304347826086,1,7,0.828055725379504,0
"['110001', '0101010', '0011100', '01000', '0', '11000', '110']",34,14,20,0.4117647058823529,0.5882352941176471,4,6,0.9774178175281716,0
"['01110', '0', '1010', '001', '0110']",17,8,9,0.4705882352941176,0.5294117647058824,2,2,0.9975025463691152,1
"['01', '00', '111', '1', '0', '10000']",14,6,8,0.4285714285714285,0.5714285714285714,2,3,0.9852281360342516,0
"['1011111', '010', '1001111']",17,12,5,0.7058823529411765,0.2941176470588235,4,1,0.8739810481273578,1
"['101001', '101100', '110', '0111', '00000', '1111', '11', '1100000', '0100', '111']",44,23,21,0.5227272727272727,0.4772727272727273,9,9,0.9985090989176322,0
"['0', '01', '110011', '1001']",13,7,6,0.5384615384615384,0.4615384615384615,2,3,0.9957274520849256,0
['1'],1,1,0,1.0,0.0,0,0,-0.0,1
['1'],1,1,0,1.0,0.0,0,0,-0.0,1
"['0010111', '011110', '11', '011', '00011', '1100111', '010110', '11', '011101', '010100']",50,30,20,0.6,0.4,11,4,0.9709505944546686,0
"['1001', '0100001', '11', '0011011']",20,10,10,0.5,0.5,3,4,1.0,1
"['1', '1', '0', '101000', '01110']",14,7,7,0.5,0.5,2,2,1.0,0
"['10', '1000', '111', '011', '0100', '1', '1', '1001', '000000']",28,12,16,0.4285714285714285,0.5714285714285714,3,6,0.9852281360342516,0
"['111', '1111', '01', '011', '1']",13,11,2,0.8461538461538461,0.1538461538461538,4,0,0.6193821946787638,0
"['10010', '0001', '1000', '110', '1010', '1', '01101', '111', '1111', '11010']",38,22,16,0.5789473684210527,0.4210526315789473,8,4,0.9819407868640976,0
"['111', '01', '01', '000', '1111', '0101011', '0', '0011100', '10', '100111']",37,21,16,0.5675675675675675,0.4324324324324324,6,4,0.9867867202680318,0
"['110010', '1011', '1', '1111011', '1100101', '00011', '1111101', '11101', '11011', '1']",48,34,14,0.7083333333333334,0.2916666666666667,13,3,0.8708644692353644,0
"['111011', '11', '1111', '000000', '0100000', '11', '1100100', '111']",37,20,17,0.5405405405405406,0.4594594594594595,8,7,0.9952525494396792,0
"['11', '10001', '0000010', '1', '01010', '01', '00011', '0', '1101']",32,14,18,0.4375,0.5625,3,5,0.9886994082884974,0
"['1010', '011', '0111', '001110', '0']",18,10,8,0.5555555555555556,0.4444444444444444,3,3,0.9910760598382222,0
"['0100101', '10', '01', '000101', '010110', '0101011', '11', '111', '0', '010']",39,20,19,0.5128205128205128,0.4871794871794871,5,5,0.999525689293649,0
['0110000'],7,2,5,0.2857142857142857,0.7142857142857143,1,2,0.863120568566631,1
"['110', '100', '101', '11', '11']",13,9,4,0.6923076923076923,0.3076923076923077,3,1,0.8904916402194913,1
"['101', '01', '110', '0', '110011', '1', '1', '10010', '0', '011010']",29,16,13,0.5517241379310345,0.4482758620689655,5,4,0.9922666387194964,0
"['1110', '01']",6,4,2,0.6666666666666666,0.3333333333333333,1,1,0.9182958340544896,1
"['100', '011', '101000']",12,5,7,0.4166666666666667,0.5833333333333334,1,2,0.9798687566511528,1
['1101'],4,3,1,0.75,0.25,1,0,0.8112781244591328,1
"['001011', '1101001', '010101', '11', '0010', '1', '1111', '1']",31,19,12,0.6129032258064516,0.3870967741935484,6,3,0.9629004147713268,0
"['0101', '01000', '10', '1011001', '0', '1']",20,9,11,0.45,0.55,1,2,0.9927744539878084,0
"['1001110', '011001', '110', '0110']",20,11,9,0.55,0.45,4,4,0.9927744539878084,0
"['11', '0100', '000', '001', '011', '0111', '01', '10000', '111110', '1100100']",39,19,20,0.4871794871794871,0.5128205128205128,7,7,0.999525689293649,0
"['0000', '01111', '00', '11', '100100', '011']",22,10,12,0.4545454545454545,0.5454545454545454,4,5,0.9940302114769564,0
"['0', '1', '010000', '10001', '00001', '001', '001110', '101001', '001000']",39,13,26,0.3333333333333333,0.6666666666666666,1,10,0.9182958340544896,0
"['111010', '0100', '10101', '010010', '000', '100']",27,11,16,0.4074074074074074,0.5925925925925926,1,6,0.975119064940866,0
"['0', '000001', '0000000', '11010']",19,4,15,0.2105263157894736,0.7894736842105263,1,6,0.7424875695421236,0
"['01', '0001', '1', '10110']",12,6,6,0.5,0.5,2,1,1.0,0
"['1', '100', '0100000', '001000', '00', '10001', '11111']",29,11,18,0.3793103448275862,0.6206896551724138,4,7,0.9575534837147482,0
"['010', '1001']",7,3,4,0.4285714285714285,0.5714285714285714,0,1,0.9852281360342516,1
"['11100', '0100', '0110']",13,6,7,0.4615384615384615,0.5384615384615384,2,2,0.9957274520849256,1
"['110001', '0011', '00011', '00100', '1010']",24,10,14,0.4166666666666667,0.5833333333333334,3,5,0.9798687566511528,1
"['1010001', '0', '0', '0', '000', '00010']",18,4,14,0.2222222222222222,0.7777777777777778,0,5,0.7642045065086203,0
"['1111', '1', '1001111', '0010001', '010101', '00111', '010010', '00']",38,20,18,0.5263157894736842,0.4736842105263157,6,6,0.9980008838722996,0
"['11000', '000', '1001110', '01011']",20,9,11,0.45,0.55,3,5,0.9927744539878084,1
"['01100', '111', '1000', '0001', '00', '1001', '100', '00', '00101']",32,12,20,0.375,0.625,4,9,0.954434002924965,0
['10111'],5,4,1,0.8,0.2,1,0,0.7219280948873623,1
"['001', '010100', '00101', '110']",17,7,10,0.4117647058823529,0.5882352941176471,1,3,0.9774178175281716,1
"['0011100', '11', '10000', '110111', '0100100', '11000', '010011']",38,18,20,0.4736842105263157,0.5263157894736842,6,9,0.9980008838722996,1
['11101'],5,4,1,0.8,0.2,1,0,0.7219280948873623,1
"['011', '10110', '000', '1', '1', '01110', '01', '11', '00010']",27,14,13,0.5185185185185185,0.4814814814814814,5,4,0.9990102708804812,0
"['1', '01']",3,2,1,0.6666666666666666,0.3333333333333333,0,0,0.9182958340544896,1
"['11', '1011001', '011000', '100', '010100', '1110', '1', '001010', '1']",36,18,18,0.5,0.5,4,5,1.0,0
['0111110'],7,5,2,0.7142857142857143,0.2857142857142857,2,0,0.863120568566631,1
"['111', '110', '0', '11100', '1', '000100']",19,10,9,0.5263157894736842,0.4736842105263157,3,4,0.9980008838722996,0
"['1100', '010100', '0110101', '11', '0000010', '00', '000001', '000']",37,12,25,0.3243243243243243,0.6756756756756757,3,9,0.9090221560878148,0
"['000', '001', '0', '11', '1101000', '0', '100']",20,7,13,0.35,0.65,2,5,0.934068055375491,0
"['1010000', '0100', '01111', '0110001', '011011', '110010', '100', '11']",40,20,20,0.5,0.5,7,6,1.0,1
"['11', '0', '0001000', '101', '101', '000', '10001', '00', '1111111']",33,16,17,0.4848484848484848,0.5151515151515151,5,6,0.9993375041688848,0
"['110', '0001011', '00110', '011110', '1100001']",28,14,14,0.5,0.5,6,6,1.0,0
"['0001', '0000001', '0000111', '1101000', '110', '0', '001110']",35,13,22,0.3714285714285714,0.6285714285714286,4,9,0.9517626756348312,0
"['111', '0010011']",10,6,4,0.6,0.4,2,2,0.9709505944546686,1
"['11', '1', '0000101', '1101000', '011110']",23,12,11,0.5217391304347826,0.4782608695652174,4,4,0.9986359641585718,0
"['0', '0', '110011', '0011', '10111', '111', '0000']",24,13,11,0.5416666666666666,0.4583333333333333,6,5,0.99498482818597,0
['0110001'],7,3,4,0.4285714285714285,0.5714285714285714,1,1,0.9852281360342516,1
"['1011', '00', '10']",8,4,4,0.5,0.5,1,1,1.0,1
"['01001', '1', '01', '1110', '00010', '100000', '00111', '01101', '11010']",38,18,20,0.4736842105263157,0.5263157894736842,6,6,0.9980008838722996,0
"['100', '011001', '000', '011', '0', '0100111', '0']",24,10,14,0.4166666666666667,0.5833333333333334,3,6,0.9798687566511528,0
"['0010010', '11', '0010000', '10', '0100011', '10001']",30,11,19,0.3666666666666666,0.6333333333333333,2,8,0.9480782435939056,1
"['0', '0', '0', '00', '11001']",10,3,7,0.3,0.7,1,3,0.8812908992306927,0
"['011111', '111', '000', '01110', '1101', '0001101', '000010', '1000', '01011']",43,22,21,0.5116279069767442,0.4883720930232558,8,7,0.999609836367807,0
"['11', '10', '0', '0100', '11011', '111101', '010', '1101110', '11001']",35,22,13,0.6285714285714286,0.3714285714285714,8,3,0.9517626756348312,0
"['00001', '110111', '101011', '1']",18,11,7,0.6111111111111112,0.3888888888888889,4,2,0.964078764808229,1
"['0001', '00']",6,1,5,0.1666666666666666,0.8333333333333334,0,2,0.6500224216483541,1
"['101', '10001', '10110', '0101', '0100111']",24,13,11,0.5416666666666666,0.4583333333333333,4,3,0.99498482818597,1
"['010101', '1', '110', '1010', '0', '111111', '10001']",26,16,10,0.6153846153846154,0.3846153846153846,5,2,0.961236604722876,0
"['1010000', '011', '1011011', '100', '1', '001']",24,12,12,0.5,0.5,3,4,1.0,0
"['11', '10', '1001', '001100', '1010']",18,9,9,0.5,0.5,2,3,1.0,0
"['1110', '100', '0101', '011010']",17,9,8,0.5294117647058824,0.4705882352941176,2,1,0.9975025463691152,1
"['1', '100']",4,2,2,0.5,0.5,1,1,1.0,1
"['0', '01010', '11', '0111', '10110', '110', '1']",21,13,8,0.6190476190476191,0.3809523809523809,5,1,0.9587118829771318,0
"['111100', '11000', '1', '1', '10010', '11010', '1', '01000', '010000']",35,16,19,0.4571428571428571,0.5428571428571428,5,7,0.9946937953613058,1
"['00', '00', '001010', '1111100', '110000', '1000100', '11']",32,13,19,0.40625,0.59375,4,8,0.9744894033980523,0
"['101', '1101101', '1100111', '1', '000100', '000111', '1', '010001', '1', '1110100']",45,25,20,0.5555555555555556,0.4444444444444444,9,6,0.9910760598382222,0
"['000', '1100010', '111111', '01', '000101', '0', '00']",27,12,15,0.4444444444444444,0.5555555555555556,4,4,0.9910760598382222,0
"['1', '10', '0010110', '0']",11,5,6,0.4545454545454545,0.5454545454545454,2,2,0.9940302114769564,0
"['1', '00', '10010', '1110111', '110000', '1', '111', '110', '11101']",33,21,12,0.6363636363636364,0.3636363636363636,7,4,0.94566030460064,0
"['01101', '000001', '10', '00011', '00101', '10111', '00000', '101100', '100110']",45,19,26,0.4222222222222222,0.5777777777777777,7,9,0.9824740868386408,1
"['111100', '01', '111', '1110010']",18,12,6,0.6666666666666666,0.3333333333333333,5,2,0.9182958340544896,1
"['101', '0011', '000', '0001', '010011']",20,8,12,0.4,0.6,2,5,0.9709505944546686,0
"['0110', '00010', '010', '010', '001']",18,6,12,0.3333333333333333,0.6666666666666666,1,5,0.9182958340544896,1
['10011'],5,3,2,0.6,0.4,1,1,0.9709505944546686,1
"['0001001', '11']",9,4,5,0.4444444444444444,0.5555555555555556,1,2,0.9910760598382222,1
['011111'],6,5,1,0.8333333333333334,0.1666666666666666,2,0,0.6500224216483541,1
['000'],3,0,3,0.0,1.0,0,1,-0.0,1
"['1', '011', '101111', '1', '1', '1000011', '0', '011100', '110011']",32,20,12,0.625,0.375,8,5,0.954434002924965,0
"['0111011', '1010110', '000101', '001', '001', '111100', '000111', '011', '01000']",46,23,23,0.5,0.5,7,7,1.0,1
"['0', '000101', '0101', '010011', '1010001', '0100', '01', '1001', '10110', '0011']",43,19,24,0.4418604651162791,0.5581395348837209,5,7,0.9902246902198684,0
['1001'],4,2,2,0.5,0.5,0,1,1.0,1
"['0', '101111', '0', '11110', '11', '0', '000011', '00001', '1']",28,15,13,0.5357142857142857,0.4642857142857143,7,4,0.996316519558962,0
"['001', '100', '00011', '0000', '1', '11000', '0100']",25,8,17,0.32,0.68,3,8,0.9043814577244936,0
"['1', '110010', '1000011', '01111', '110', '10100', '000', '0', '1010110', '0']",39,19,20,0.4871794871794871,0.5128205128205128,6,7,0.999525689293649,0
"['00', '0101001', '1011', '1110000', '1', '0001', '010110', '101']",34,16,18,0.4705882352941176,0.5294117647058824,4,5,0.9975025463691152,0
"['1100101', '01', '0010', '11', '0111011', '11', '10011', '00', '111100']",37,22,15,0.5945945945945946,0.4054054054054054,8,5,0.974024864435752,0
"['1010011', '110000', '1', '1110', '0']",19,10,9,0.5263157894736842,0.4736842105263157,4,4,0.9980008838722996,0
"['10011', '1101', '00', '001', '1101', '011100', '010', '1101001']",34,18,16,0.5294117647058824,0.4705882352941176,5,5,0.9975025463691152,0
['00'],2,0,2,0.0,1.0,0,1,-0.0,1
"['00111', '00', '10111', '001', '000', '1']",19,9,10,0.4736842105263157,0.5263157894736842,2,4,0.9980008838722996,0
"['00', '1', '111', '100101', '0101', '1000', '1001111', '00110', '00010', '1101']",41,21,20,0.5121951219512195,0.4878048780487805,7,7,0.9995708393473224,0
"['00', '111011', '10', '10111', '000', '01001']",23,12,11,0.5217391304347826,0.4782608695652174,3,4,0.9986359641585718,0
"['010', '1011001', '1010', '100001']",20,9,11,0.45,0.55,2,3,0.9927744539878084,1
"['00011', '010', '1110100', '11001', '1110100', '11011', '010111', '0011101', '1100111', '1111011']",59,37,22,0.6271186440677966,0.3728813559322034,14,6,0.9528588097297788,0
"['0101001', '00011', '0100011', '0', '00', '00', '0110', '011', '10']",33,13,20,0.3939393939393939,0.6060606060606061,4,7,0.9672947789468944,0
"['1', '0001', '101', '1']",9,5,4,0.5555555555555556,0.4444444444444444,2,1,0.9910760598382222,1
"['1000', '0', '001010', '01100']",16,5,11,0.3125,0.6875,1,5,0.8960382325345574,1
"['10101', '1000001', '1']",13,6,7,0.4615384615384615,0.5384615384615384,2,2,0.9957274520849256,1
"['001', '1111010', '1', '00']",13,7,6,0.5384615384615384,0.4615384615384615,2,2,0.9957274520849256,0
"['111100', '10', '11', '00']",12,7,5,0.5833333333333334,0.4166666666666667,3,2,0.9798687566511528,0
"['0', '1']",2,1,1,0.5,0.5,0,0,1.0,1
"['00001', '00111', '110000', '00010']",21,7,14,0.3333333333333333,0.6666666666666666,2,6,0.9182958340544896,1
"['111110', '1011', '1110111', '10', '11000', '1010', '010001', '0001', '1100']",42,24,18,0.5714285714285714,0.4285714285714285,8,5,0.9852281360342516,0
"['101', '1000011', '0101101', '001111']",23,13,10,0.5652173913043478,0.4347826086956521,5,3,0.9876925088958034,1
"['11', '1', '1', '0011', '0', '1000', '011111', '000001']",25,13,12,0.52,0.48,5,5,0.9988455359952018,0
"['0', '1110', '010000', '00111', '1001010', '1101100', '011', '1', '10100']",39,19,20,0.4871794871794871,0.5128205128205128,7,7,0.999525689293649,0
"['1100110', '11000', '11']",14,8,6,0.5714285714285714,0.4285714285714285,4,2,0.9852281360342516,1
"['1101001', '11101', '101010', '1', '01', '100100', '1', '0001']",32,17,15,0.53125,0.46875,5,4,0.9971803988942642,0
"['010101', '11', '1110001', '0001', '1010010', '01', '10', '0', '1101', '111']",38,21,17,0.5526315789473685,0.4473684210526316,8,5,0.9919924034538556,0
"['00100', '10110', '011', '1', '10001', '0110100', '100', '1100']",33,15,18,0.4545454545454545,0.5454545454545454,5,7,0.9940302114769564,0
"['0110000', '0100', '0', '000001']",18,4,14,0.2222222222222222,0.7777777777777778,1,6,0.7642045065086203,0
"['1110101', '1110011', '00101', '1100011']",26,16,10,0.6153846153846154,0.3846153846153846,6,3,0.961236604722876,1
['11'],2,2,0,1.0,0.0,1,0,-0.0,1
"['10100', '111', '110000', '1', '01100', '1', '0']",22,11,11,0.5,0.5,3,4,1.0,0
"['100100', '0000000', '00', '1111100', '110']",25,9,16,0.36,0.64,3,7,0.9426831892554922,0
"['1100111', '10001', '010', '100010', '1010011', '010', '01', '1']",34,17,17,0.5,0.5,5,5,1.0,0
"['00010', '0', '1', '010', '10110', '01', '00010']",22,8,14,0.3636363636363636,0.6363636363636364,1,4,0.94566030460064,0
"['000', '011']",6,2,4,0.3333333333333333,0.6666666666666666,1,2,0.9182958340544896,1
"['1100', '1101011', '11', '1111', '001', '010', '1', '0010100', '100']",34,19,15,0.5588235294117647,0.4411764705882353,6,5,0.9899927915575186,0
"['0001', '10111']",9,5,4,0.5555555555555556,0.4444444444444444,2,1,0.9910760598382222,1
"['1000001', '0001001']",14,4,10,0.2857142857142857,0.7142857142857143,0,4,0.863120568566631,1
"['1011001', '0', '000', '00', '1000001', '001']",23,7,16,0.3043478260869565,0.6956521739130435,1,7,0.8865408928220899,0
"['1110', '1100101', '001111', '1111111', '01', '0101', '0000', '1101000', '010111', '110']",50,30,20,0.6,0.4,10,6,0.9709505944546686,0
"['01000', '110', '0']",9,3,6,0.3333333333333333,0.6666666666666666,1,2,0.9182958340544896,1
"['0111110', '1', '010000', '00', '000']",19,7,12,0.3684210526315789,0.631578947368421,2,4,0.9494520153879484,0
"['01', '1000000', '0110', '001100', '110001', '01100', '111', '010100', '0111110']",46,21,25,0.4565217391304347,0.5434782608695652,8,8,0.994538681650011,0
"['1101', '01101', '01', '111', '000100']",20,11,9,0.55,0.45,4,2,0.9927744539878084,1
"['0', '111', '0', '010']",8,4,4,0.5,0.5,1,1,1.0,1
"['0110111', '0010100', '1', '11', '010', '00', '00', '0000100']",31,12,19,0.3870967741935484,0.6129032258064516,3,7,0.9629004147713268,0
"['101', '01', '0001110']",12,6,6,0.5,0.5,1,1,1.0,1
"['00', '111', '001010', '010', '11']",16,8,8,0.5,0.5,2,3,1.0,0
"['0', '011011', '10011', '1100010', '1']",20,11,9,0.55,0.45,4,3,0.9927744539878084,0
"['100001', '0001111', '1111111', '1010', '01111', '000', '0', '11', '101', '1110101']",45,28,17,0.6222222222222222,0.3777777777777777,11,6,0.9564574047992594,0
"['0101', '011010', '01010']",15,7,8,0.4666666666666667,0.5333333333333333,1,1,0.9967916319816366,1
"['011', '01', '10', '01', '110', '0111', '0']",17,10,7,0.5882352941176471,0.4117647058823529,4,2,0.9774178175281716,0
"['011000', '01', '010000', '00', '00', '110']",21,6,15,0.2857142857142857,0.7142857142857143,2,6,0.863120568566631,0
"['0', '1000', '11', '0111001', '1000010', '0', '01101', '1110010', '101111']",40,21,19,0.525,0.475,8,6,0.99819587904281,0
"['100', '10101', '0', '0', '1100', '00001']",19,7,12,0.3684210526315789,0.631578947368421,1,5,0.9494520153879484,0
"['10', '11', '1', '101100', '100', '1111111', '11', '011101']",29,21,8,0.7241379310344828,0.2758620689655172,8,2,0.8497511372532974,0
"['1000', '11']",6,3,3,0.5,0.5,1,1,1.0,1
"['110110', '0', '101001', '1101', '010111', '1110010', '0100100', '1010', '0111']",45,25,20,0.5555555555555556,0.4444444444444444,7,7,0.9910760598382222,0
"['1101', '01101', '10', '1', '111', '001', '0011101', '0110', '001']",32,19,13,0.59375,0.40625,7,3,0.9744894033980523,0
"['10011', '101', '11111', '0010101', '010000', '101001', '1', '11100', '010']",41,22,19,0.5365853658536586,0.4634146341463415,6,6,0.9961344835095796,0
['100'],3,1,2,0.3333333333333333,0.6666666666666666,0,1,0.9182958340544896,1
"['01', '101']",5,3,2,0.6,0.4,1,0,0.9709505944546686,1
['1101'],4,3,1,0.75,0.25,1,0,0.8112781244591328,1
"['0', '0', '011100']",8,3,5,0.375,0.625,1,2,0.954434002924965,1
"['011111', '0111', '0100011', '01']",19,12,7,0.631578947368421,0.3684210526315789,4,1,0.9494520153879484,1
"['110', '1', '0101', '1101', '1', '0']",14,9,5,0.6428571428571429,0.3571428571428571,3,0,0.9402859586706313,0
"['0001', '11010', '1']",10,5,5,0.5,0.5,1,1,1.0,1
"['1101', '0110000', '0111', '0111', '011011', '000100', '010', '10', '111']",39,21,18,0.5384615384615384,0.4615384615384615,7,4,0.9957274520849256,1
"['10', '001', '0', '1000110', '111', '101001', '0011111', '11']",31,18,13,0.5806451612903226,0.4193548387096774,6,4,0.9811522341999132,0
"['10000', '1100101', '001', '0000', '0010100', '0', '110', '011', '010', '011']",39,15,24,0.3846153846153846,0.6153846153846154,4,10,0.961236604722876,0
"['0000', '1', '011101', '0', '0000011', '00', '1110']",25,10,15,0.4,0.6,3,6,0.9709505944546686,0
"['1', '001101', '01110', '1100', '01100', '1', '011111']",28,17,11,0.6071428571428571,0.3928571428571428,6,3,0.9666186325481028,0
"['1', '0001010', '1100011', '11111', '00011', '0', '100011']",32,17,15,0.53125,0.46875,6,4,0.9971803988942642,0
['0010'],4,1,3,0.25,0.75,0,1,0.8112781244591328,1
"['0', '1001', '111']",8,5,3,0.625,0.375,2,1,0.954434002924965,1
['0'],1,0,1,0.0,1.0,0,0,-0.0,1
"['0010010', '0101110', '01', '101', '1110110', '1', '111', '011101', '0']",37,22,15,0.5945945945945946,0.4054054054054054,8,4,0.974024864435752,0
"['0100110', '111', '0011', '010', '0101001', '1100100', '1111011', '0100100', '1']",46,24,22,0.5217391304347826,0.4782608695652174,7,8,0.9986359641585718,0
"['101', '111010', '0000', '11001', '10']",20,10,10,0.5,0.5,4,3,1.0,1
"['0', '1100', '10000', '110100', '111001', '1010101', '0', '010', '1011001', '0010']",44,20,24,0.4545454545454545,0.5454545454545454,5,8,0.9940302114769564,0
"['111', '011', '1', '001010', '111', '101', '0', '11']",22,15,7,0.6818181818181818,0.3181818181818182,5,1,0.9023932827949788,0
"['0', '100001']",7,2,5,0.2857142857142857,0.7142857142857143,0,2,0.863120568566631,1
['000011'],6,2,4,0.3333333333333333,0.6666666666666666,1,2,0.9182958340544896,1
"['01010', '1000110']",12,5,7,0.4166666666666667,0.5833333333333334,1,1,0.9798687566511528,1
"['0101', '010001', '11010', '00111', '01101', '01']",27,14,13,0.5185185185185185,0.4814814814814814,3,2,0.9990102708804812,0
"['001', '110', '1101', '1011']",14,9,5,0.6428571428571429,0.3571428571428571,4,1,0.9402859586706313,1
"['1100011', '001', '011', '1011', '1']",18,11,7,0.6111111111111112,0.3888888888888889,4,2,0.964078764808229,0
"['0', '010', '0010', '11', '10110', '001', '001011', '1010100', '100110', '00001']",42,18,24,0.4285714285714285,0.5714285714285714,4,8,0.9852281360342516,0
"['110', '000', '00100', '000110', '1010011', '01110', '00101', '11', '101']",39,18,21,0.4615384615384615,0.5384615384615384,6,7,0.9957274520849256,0
"['1001000', '1', '11', '0', '1010', '10']",17,8,9,0.4705882352941176,0.5294117647058824,1,2,0.9975025463691152,0
"['000', '000', '100100', '0001', '1', '10001', '00010', '01']",29,8,21,0.2758620689655172,0.7241379310344828,1,9,0.8497511372532974,0
"['1010', '01', '0', '1100111', '11']",16,10,6,0.625,0.375,3,2,0.954434002924965,0
"['0110101', '10', '1000110', '1100', '101']",23,12,11,0.5217391304347826,0.4782608695652174,4,2,0.9986359641585718,0
"['1', '10', '10', '00101']",10,5,5,0.5,0.5,1,1,1.0,1
"['01', '11011', '1000010']",14,7,7,0.5,0.5,2,2,1.0,1
"['1110', '0', '0000', '1', '110', '010', '1010']",20,9,11,0.45,0.55,2,4,0.9927744539878084,0
"['0111110', '1111110', '1100100', '1011101', '001', '0', '11', '10', '0101100']",43,26,17,0.6046511627906976,0.3953488372093023,9,5,0.9681647320759544,0
"['1', '01', '01']",5,3,2,0.6,0.4,0,0,0.9709505944546686,1
"['10', '1011', '0001', '0', '1101', '010110', '11', '1110']",27,16,11,0.5925925925925926,0.4074074074074074,5,1,0.975119064940866,0
"['01011', '1011']",9,6,3,0.6666666666666666,0.3333333333333333,2,0,0.9182958340544896,1
"['00', '1000011']",9,3,6,0.3333333333333333,0.6666666666666666,1,3,0.9182958340544896,1
"['0101', '01', '110010', '1', '000100', '1000100', '0010100', '0']",34,12,22,0.3529411764705882,0.6470588235294118,1,7,0.9366673818775626,0
"['00000', '1000001', '1100', '100110', '0001110', '010011']",35,13,22,0.3714285714285714,0.6285714285714286,4,10,0.9517626756348312,1
"['01', '110', '1110010', '0111', '0111']",20,13,7,0.65,0.35,4,2,0.934068055375491,1
"['0101000', '1000011', '100111', '11110', '001110']",31,16,15,0.5161290322580645,0.4838709677419355,5,5,0.9992492479956564,1
"['11', '10']",4,3,1,0.75,0.25,1,0,0.8112781244591328,1
"['010', '010', '001', '00', '1', '1001110', '010', '011', '00']",27,11,16,0.4074074074074074,0.5925925925925926,3,7,0.975119064940866,0
"['011100', '1', '001', '101011', '01010', '11', '0010']",27,14,13,0.5185185185185185,0.4814814814814814,4,3,0.9990102708804812,0
"['10', '110', '10010']",10,5,5,0.5,0.5,1,1,1.0,1
"['00', '00111', '010010', '01010', '0001', '100', '0', '1100101', '0111', '01000']",42,17,25,0.4047619047619047,0.5952380952380952,4,9,0.97366806454962,0
"['1001', '1010010', '1', '011', '0101111', '10001', '00111', '01']",34,19,15,0.5588235294117647,0.4411764705882353,5,4,0.9899927915575186,0
"['01010', '1101110', '0010', '1010', '1001011', '01111', '0010110']",39,21,18,0.5384615384615384,0.4615384615384615,6,3,0.9957274520849256,1
"['010', '10', '10', '10101', '10110', '00001']",22,10,12,0.4545454545454545,0.5454545454545454,2,2,0.9940302114769564,0
"['0', '10110', '00', '011010', '1111011', '1011111']",28,18,10,0.6428571428571429,0.3571428571428571,7,2,0.9402859586706313,0
"['1101', '111111']",10,9,1,0.9,0.1,4,0,0.4689955935892812,1
"['000100', '11110', '11', '11', '101']",18,11,7,0.6111111111111112,0.3888888888888889,4,2,0.964078764808229,1
"['0110010', '01111', '0010', '11', '10110', '011001']",29,16,13,0.5517241379310345,0.4482758620689655,6,5,0.9922666387194964,0
"['000', '0']",4,0,4,0.0,1.0,0,2,-0.0,0
"['1111110', '0011', '0100', '0101001', '1010001', '01101', '1', '0', '100', '010000']",45,21,24,0.4666666666666667,0.5333333333333333,7,7,0.9967916319816366,0
"['0', '01', '1001011', '101', '001110', '001011']",25,13,12,0.52,0.48,4,4,0.9988455359952018,0
"['0010100', '1', '1100', '010101', '10101', '1010']",27,13,14,0.4814814814814814,0.5185185185185185,3,3,0.9990102708804812,0
"['010110', '01101', '110100']",17,9,8,0.5294117647058824,0.4705882352941176,3,2,0.9975025463691152,1
"['11', '1111']",6,6,0,1.0,0.0,3,0,-0.0,0
"['100', '10010', '0101', '111', '101', '01', '010']",23,12,11,0.5217391304347826,0.4782608695652174,2,3,0.9986359641585718,0
"['11101', '0100100', '00', '111100', '110010', '001', '0', '0', '0000']",35,14,21,0.4,0.6,4,9,0.9709505944546686,0
"['101010', '00000', '1100', '11100', '011100', '0', '000101', '111110']",39,18,21,0.4615384615384615,0.5384615384615384,6,8,0.9957274520849256,0
"['11', '00', '011', '10', '11', '1101100', '10001']",23,13,10,0.5652173913043478,0.4347826086956521,5,3,0.9876925088958034,0
['11'],2,2,0,1.0,0.0,1,0,-0.0,1
"['111000', '101010']",12,6,6,0.5,0.5,1,1,1.0,1
"['001100', '1000', '1010', '11011']",19,9,10,0.4736842105263157,0.5263157894736842,3,3,0.9980008838722996,1
"['1001100', '00', '11100', '110', '0110', '1100110']",28,14,14,0.5,0.5,6,6,1.0,0
"['11000', '1', '1', '101111', '00', '01011']",20,12,8,0.6,0.4,5,2,0.9709505944546686,0
['101'],3,2,1,0.6666666666666666,0.3333333333333333,0,0,0.9182958340544896,1
['001'],3,1,2,0.3333333333333333,0.6666666666666666,0,1,0.9182958340544896,1
"['00', '0110', '11', '100011', '110111', '01', '100', '11']",27,16,11,0.5925925925925926,0.4074074074074074,7,3,0.975119064940866,0
"['1100101', '1011', '0', '11011', '0', '1000']",22,12,10,0.5454545454545454,0.4545454545454545,5,2,0.9940302114769564,1
"['010101', '101000', '01100', '00', '10101', '010110']",30,13,17,0.4333333333333333,0.5666666666666667,3,4,0.9871377743721864,1
"['0011', '111111', '1101', '000', '001', '001110', '100', '110', '1000100']",39,20,19,0.5128205128205128,0.4871794871794871,7,7,0.999525689293649,0
"['1111111', '11', '01', '1101', '1', '01', '01011']",23,18,5,0.782608695652174,0.217391304347826,7,0,0.7553754125614287,0
"['1010000', '0', '1011', '01', '01', '011000', '000000', '1']",29,10,19,0.3448275862068966,0.6551724137931034,2,6,0.9293636260137188,0
"['010', '0111001', '11']",12,7,5,0.5833333333333334,0.4166666666666667,2,2,0.9798687566511528,1
"['0', '10', '001000', '0000100', '0000100', '0101', '00', '0100', '0000111']",40,10,30,0.25,0.75,1,12,0.8112781244591328,0
"['01110', '110', '01', '000', '01', '01', '10']",19,9,10,0.4736842105263157,0.5263157894736842,3,3,0.9980008838722996,0
"['1010', '10011', '1111011', '0100', '11', '1']",23,15,8,0.6521739130434783,0.3478260869565217,5,2,0.9321115676166748,0
"['01', '00000', '100', '000001', '0', '0010010', '111', '111', '01']",32,12,20,0.375,0.625,3,7,0.954434002924965,0
"['111001', '11']",8,6,2,0.75,0.25,2,1,0.8112781244591328,1
"['00010', '0110', '00011', '10', '011111']",22,11,11,0.5,0.5,4,5,1.0,1
"['111010', '1101', '0', '00', '11001', '01']",20,11,9,0.55,0.45,3,2,0.9927744539878084,0
"['1', '1011', '011000', '01', '0001001', '10']",22,10,12,0.4545454545454545,0.5454545454545454,4,4,0.9940302114769564,0
"['00010', '0', '0', '0110000', '101', '11', '1111100', '0']",27,12,15,0.4444444444444444,0.5555555555555556,5,6,0.9910760598382222,0
"['001001', '0011', '001', '1011', '0', '0100001', '01', '01', '1']",30,13,17,0.4333333333333333,0.5666666666666667,4,7,0.9871377743721864,0
"['1001000', '1', '100', '11001', '000010', '00', '01', '0', '001101']",33,12,21,0.3636363636363636,0.6363636363636364,3,9,0.94566030460064,0
"['1101', '0110011', '0', '01', '001010', '011', '1011', '111', '011', '00000']",38,20,18,0.5263157894736842,0.4736842105263157,7,6,0.9980008838722996,0
"['1000', '01001', '1', '01', '1001', '0']",17,7,10,0.4117647058823529,0.5882352941176471,2,4,0.9774178175281716,0
"['1110111', '111100', '001', '00']",18,11,7,0.6111111111111112,0.3888888888888889,4,3,0.964078764808229,1
"['000101', '1110011', '101000', '1010000', '1011', '001011', '1111']",40,21,19,0.525,0.475,7,6,0.99819587904281,1
"['0110', '0101', '1100111', '0110001', '01110']",27,15,12,0.5555555555555556,0.4444444444444444,5,3,0.9910760598382222,1
"['10', '00110', '01010']",12,5,7,0.4166666666666667,0.5833333333333334,1,2,0.9798687566511528,1
"['0', '11', '100', '0101']",10,5,5,0.5,0.5,1,1,1.0,1
['100010'],6,2,4,0.3333333333333333,0.6666666666666666,0,1,0.9182958340544896,1
['01101'],5,3,2,0.6,0.4,1,0,0.9709505944546686,1
"['0', '1110', '1110100']",12,7,5,0.5833333333333334,0.4166666666666667,2,1,0.9798687566511528,1
['1101'],4,3,1,0.75,0.25,1,0,0.8112781244591328,1
"['1000100', '0011111']",14,7,7,0.5,0.5,2,3,1.0,1
"['000', '01', '100011', '0110', '1', '00', '1', '10', '1', '00']",24,10,14,0.4166666666666667,0.5833333333333334,4,5,0.9798687566511528,0
"['010101', '1001', '0011101']",17,9,8,0.5294117647058824,0.4705882352941176,2,2,0.9975025463691152,1
"['10011', '0101011']",12,7,5,0.5833333333333334,0.4166666666666667,2,1,0.9798687566511528,1
"['1110', '100', '111', '0000', '01', '0']",17,8,9,0.4705882352941176,0.5294117647058824,2,3,0.9975025463691152,0
"['01101', '00011', '011', '000000', '0', '0110', '110', '1011', '010', '100000']",40,16,24,0.4,0.6,6,7,0.9709505944546686,0
"['0011011', '0', '0100011', '011111', '00100']",26,13,13,0.5,0.5,5,5,1.0,1
"['00', '0101011', '1', '0000011', '01110', '0010', '11110', '1', '01']",34,17,17,0.5,0.5,5,4,1.0,0
"['0100000', '100011', '11101', '1', '0111111', '10101', '001', '00', '00', '11001']",43,22,21,0.5116279069767442,0.4883720930232558,7,7,0.999609836367807,0
"['000', '1101', '1', '0', '1', '000011', '01110', '10']",23,11,12,0.4782608695652174,0.5217391304347826,4,3,0.9986359641585718,0
"['0', '10010', '011101', '010101', '0100101', '00']",27,12,15,0.4444444444444444,0.5555555555555556,1,4,0.9910760598382222,0
"['10111', '011010', '00', '01', '101', '10', '100001', '011', '01101']",34,18,16,0.5294117647058824,0.4705882352941176,6,4,0.9975025463691152,0
"['1001', '01101', '11010', '01100', '0', '010001', '1', '1']",28,14,14,0.5,0.5,4,5,1.0,0
"['0001100', '0']",8,2,6,0.25,0.75,1,2,0.8112781244591328,1
"['00010', '0', '00011', '110101', '0', '0011', '100110', '110']",31,14,17,0.4516129032258064,0.5483870967741935,5,5,0.9932338197397066,0
"['01101', '000001', '10', '00011', '000111', '010', '111111', '0100', '100111', '0']",44,22,22,0.5,0.5,8,7,1.0,0
"['1100', '101', '01', '110', '110', '110000', '0', '10011', '1']",28,15,13,0.5357142857142857,0.4642857142857143,5,4,0.996316519558962,0
"['0010', '0010', '11100', '10110', '00000', '000000', '10', '10111']",36,13,23,0.3611111111111111,0.6388888888888888,3,9,0.943601631299382,0
"['0100100', '011110', '0']",14,6,8,0.4285714285714285,0.5714285714285714,2,3,0.9852281360342516,1
"['0000', '010110']",10,3,7,0.3,0.7,1,2,0.8812908992306927,1
"['01', '111']",5,4,1,0.8,0.2,2,0,0.7219280948873623,1
"['1101100', '11', '0', '01111', '1100', '01111']",24,16,8,0.6666666666666666,0.3333333333333333,8,3,0.9182958340544896,0
['10'],2,1,1,0.5,0.5,0,0,1.0,1
"['101100', '11010', '0100111', '1', '00010', '10010', '11']",31,16,15,0.5161290322580645,0.4838709677419355,5,5,0.9992492479956564,0
"['011', '0', '1100', '00', '1111110', '000', '110001', '11', '1100010', '1001011']",42,22,20,0.5238095238095238,0.4761904761904761,9,7,0.998363672593813,0
"['01', '00010', '0101', '0', '1000', '11001', '0110', '110']",28,12,16,0.4285714285714285,0.5714285714285714,3,4,0.9852281360342516,0
"['1110001', '110100', '0', '011111', '01', '10011', '10001', '111']",35,21,14,0.6,0.4,8,5,0.9709505944546686,0
['011001'],6,3,3,0.5,0.5,1,1,1.0,1
"['01', '000011', '1', '10101', '10010', '0111001', '101']",29,15,14,0.5172413793103449,0.4827586206896552,5,5,0.9991421039919088,0
"['0101101', '1000110', '111', '111101', '011', '1', '1', '0000', '0001']",36,20,16,0.5555555555555556,0.4444444444444444,8,4,0.9910760598382222,0
"['10', '10110', '0000010']",14,5,9,0.3571428571428571,0.6428571428571429,1,3,0.9402859586706313,1
"['100', '0101101', '01101', '101', '001', '0', '0100010', '1001', '10100', '10']",40,18,22,0.45,0.55,4,6,0.9927744539878084,0
"['101', '1000000', '1']",11,4,7,0.3636363636363636,0.6363636363636364,1,3,0.94566030460064,1
"['10', '1010111', '1', '101000', '0000', '0000111', '10110', '111001', '01', '00110']",45,22,23,0.4888888888888889,0.5111111111111111,7,7,0.999643749677856,0
"['000100', '100', '10001', '0111110', '0', '11']",24,11,13,0.4583333333333333,0.5416666666666666,3,5,0.99498482818597,0
"['0000', '000', '00000', '010100', '11001', '10010', '1110', '11']",34,12,22,0.3529411764705882,0.6470588235294118,4,9,0.9366673818775626,0
['100000'],6,1,5,0.1666666666666666,0.8333333333333334,0,2,0.6500224216483541,1
"['100111', '1010', '110100', '0010101', '11100', '1', '011110', '00101']",40,22,18,0.55,0.45,7,5,0.9927744539878084,0
"['1101010', '001101', '1000', '000', '0000']",24,8,16,0.3333333333333333,0.6666666666666666,3,6,0.9182958340544896,0
"['00', '01', '10001', '00001', '101', '110', '10', '0111011', '01', '11111']",36,20,16,0.5555555555555556,0.4444444444444444,8,5,0.9910760598382222,0
"['010100', '10', '0110', '11100', '0111000', '11', '1001', '0111010', '00100', '101']",45,22,23,0.4888888888888889,0.5111111111111111,5,7,0.999643749677856,0
"['11011', '0', '1111', '1', '100001']",17,11,6,0.6470588235294118,0.3529411764705882,5,2,0.9366673818775626,0
"['110000', '11', '0011011', '1010100', '100', '100']",28,13,15,0.4642857142857143,0.5357142857142857,4,6,0.996316519558962,1
"['0', '0', '10', '1', '1100110', '0011']",16,8,8,0.5,0.5,3,3,1.0,0
"['110110', '10', '0', '00']",11,5,6,0.4545454545454545,0.5454545454545454,2,2,0.9940302114769564,0
"['1', '1']",2,2,0,1.0,0.0,1,0,-0.0,1
"['01011', '01110', '0', '1', '1010', '101', '101', '011111', '0010', '01']",34,20,14,0.5882352941176471,0.4117647058823529,6,3,0.9774178175281716,0
"['01', '001']",5,2,3,0.4,0.6,0,1,0.9709505944546686,1
"['000001', '01111', '011000', '10', '1001000', '1110011', '110100', '101101', '0110011', '001111']",58,30,28,0.5172413793103449,0.4827586206896552,11,9,0.9991421039919088,1
"['1110100', '011', '0']",11,6,5,0.5454545454545454,0.4545454545454545,2,1,0.9940302114769564,1
"['0111111', '01111']",12,10,2,0.8333333333333334,0.1666666666666666,5,0,0.6500224216483541,1
"['0001', '11010', '01000', '10', '10101', '0']",22,9,13,0.4090909090909091,0.5909090909090909,1,3,0.9760206482366148,0
"['11000', '00', '111', '10', '0', '1011', '001', '000']",23,10,13,0.4347826086956521,0.5652173913043478,4,5,0.9876925088958034,0
"['1', '1010110', '0010', '100', '0110101', '100']",25,12,13,0.48,0.52,4,3,0.9988455359952018,1
"['0000', '11111', '000100', '1100', '100', '101', '1', '0100100']",33,14,19,0.4242424242424242,0.5757575757575758,4,8,0.9833761901392236,0
"['1100', '011', '1111']",11,8,3,0.7272727272727273,0.2727272727272727,4,1,0.8453509366224364,1
"['110001', '10', '01', '0', '0', '01001', '01011']",22,10,12,0.4545454545454545,0.5454545454545454,3,4,0.9940302114769564,0
"['10', '1110010']",9,5,4,0.5555555555555556,0.4444444444444444,1,1,0.9910760598382222,1
"['1001111', '01', '11', '0', '101100', '1', '10011', '10', '0', '1']",28,17,11,0.6071428571428571,0.3928571428571428,6,4,0.9666186325481028,0
"['0001', '0010100', '0110', '0111', '00', '1', '1011110', '0001001']",36,16,20,0.4444444444444444,0.5555555555555556,5,8,0.9910760598382222,0
"['11', '010000', '00111', '1', '111', '0', '10101', '10']",25,14,11,0.56,0.44,5,3,0.9895875212220556,0
"['01', '1', '0110011']",10,6,4,0.6,0.4,3,1,0.9709505944546686,1
"['111', '00101', '10', '0', '0', '111011', '0', '0000', '1']",24,12,12,0.5,0.5,4,4,1.0,0
"['0010', '0110001', '1', '100', '0011000', '010', '11000', '0011100']",37,14,23,0.3783783783783784,0.6216216216216216,5,10,0.9568886656798212,0
"['01', '001011', '0001110', '11', '1111', '1110000']",28,16,12,0.5714285714285714,0.4285714285714285,6,4,0.9852281360342516,0
"['10', '11', '11', '011']",9,7,2,0.7777777777777778,0.2222222222222222,3,0,0.7642045065086203,1
"['010000', '011', '1', '1110000', '1011011', '11', '1100010']",33,17,16,0.5151515151515151,0.4848484848484848,7,5,0.9993375041688848,0
"['110', '1101001', '0111', '010011', '0011', '101000']",30,16,14,0.5333333333333333,0.4666666666666667,5,4,0.9967916319816366,1
"['1001110', '0', '110']",11,6,5,0.5454545454545454,0.4545454545454545,2,2,0.9940302114769564,1
"['00', '000010', '10010', '10100', '01001', '001001', '11010', '110', '1010010']",44,17,27,0.3863636363636363,0.6136363636363636,2,9,0.9624127354629924,0
"['10', '00010', '0001100', '01', '0']",17,5,12,0.2941176470588235,0.7058823529411765,1,5,0.8739810481273578,0
['0'],1,0,1,0.0,1.0,0,0,-0.0,1
"['001', '1', '000', '1']",8,3,5,0.375,0.625,1,2,0.954434002924965,1
"['1', '100']",4,2,2,0.5,0.5,1,1,1.0,1
"['1', '101011', '11', '1101', '1', '000011', '001', '11100']",28,17,11,0.6071428571428571,0.3928571428571428,8,4,0.9666186325481028,0
"['1111', '01001', '101', '001100', '01']",20,11,9,0.55,0.45,4,3,0.9927744539878084,1
"['00', '00', '01111', '011']",12,6,6,0.5,0.5,3,2,1.0,1
"['10000', '0011', '001000', '0101', '11000', '1011000']",31,11,20,0.3548387096774194,0.6451612903225806,3,8,0.9383153522334068,1
"['0', '0', '10', '1001', '1111', '1001100', '1']",20,11,9,0.55,0.45,4,4,0.9927744539878084,0
"['1011011', '1010', '111', '110', '00101', '000000', '01']",30,15,15,0.5,0.5,4,4,1.0,1
['1100'],4,2,2,0.5,0.5,1,1,1.0,1
['001000'],6,1,5,0.1666666666666666,0.8333333333333334,0,2,0.6500224216483541,1
"['10', '100', '111', '100010', '10001', '1', '1']",21,11,10,0.5238095238095238,0.4761904761904761,3,3,0.998363672593813,0
['1'],1,1,0,1.0,0.0,0,0,-0.0,1
"['0011011', '111001', '001011', '00', '00001', '10', '1101100', '0', '1101001', '0010']",47,22,25,0.4680851063829787,0.5319148936170213,8,9,0.9970590569034106,0
"['10011', '011000', '11101', '1']",17,10,7,0.5882352941176471,0.4117647058823529,4,2,0.9774178175281716,1
"['1010', '0']",5,2,3,0.4,0.6,0,1,0.9709505944546686,1
['00001'],5,1,4,0.2,0.8,0,2,0.7219280948873623,1
"['010', '0001110', '100001', '1000', '10', '1000101', '1101', '111', '0111', '110111']",46,25,21,0.5434782608695652,0.4565217391304347,8,6,0.994538681650011,0
"['0', '0101']",5,2,3,0.4,0.6,0,1,0.9709505944546686,1
"['00', '1000010', '1110011', '1101', '110', '01010', '010100']",34,16,18,0.4705882352941176,0.5294117647058824,4,7,0.9975025463691152,1
"['1', '0', '0', '001110', '01', '001111', '011100', '111011', '0000', '01']",35,18,17,0.5142857142857142,0.4857142857142857,6,7,0.9994110647387552,0
"['1011', '0', '000', '101', '0']",12,5,7,0.4166666666666667,0.5833333333333334,1,2,0.9798687566511528,0
"['0000', '111011', '1111010', '11']",19,12,7,0.631578947368421,0.3684210526315789,5,2,0.9494520153879484,1
"['00111', '110', '1']",9,6,3,0.6666666666666666,0.3333333333333333,2,1,0.9182958340544896,1
"['101110', '11', '0']",9,6,3,0.6666666666666666,0.3333333333333333,2,0,0.9182958340544896,1
"['1011', '1001', '11', '110100', '0']",17,10,7,0.5882352941176471,0.4117647058823529,3,2,0.9774178175281716,0
"['001', '0100111', '0111', '1011', '01', '100', '0011010', '0011', '1101011', '110']",44,25,19,0.5681818181818182,0.4318181818181818,10,5,0.9865446300055644,0
"['1101', '0', '01', '010', '0', '11', '100100', '01000', '00010', '001']",32,12,20,0.375,0.625,2,8,0.954434002924965,0
"['11', '110000', '10101', '1000', '00', '10', '10010', '1001']",30,13,17,0.4333333333333333,0.5666666666666667,3,6,0.9871377743721864,0
"['101000', '1001', '0111', '011110', '10', '1', '01']",25,14,11,0.56,0.44,3,2,0.9895875212220556,0
"['10', '1', '011101']",9,6,3,0.6666666666666666,0.3333333333333333,1,0,0.9182958340544896,0
"['1010', '0110110', '100', '000', '0', '010']",21,8,13,0.3809523809523809,0.6190476190476191,2,4,0.9587118829771318,0
"['001011', '000', '1111', '00', '10', '0101', '0', '01', '00', '0010']",30,12,18,0.4,0.6,3,7,0.9709505944546686,0
"['100', '101101', '101001', '10', '01010', '0011', '0010110', '11']",35,18,17,0.5142857142857142,0.4857142857142857,6,5,0.9994110647387552,0
"['1', '11', '010', '0', '1000010', '11001']",19,9,10,0.4736842105263157,0.5263157894736842,2,4,0.9980008838722996,0
"['1111110', '10111', '11', '10010', '0011']",23,16,7,0.6956521739130435,0.3043478260869565,7,2,0.8865408928220899,1
['00'],2,0,2,0.0,1.0,0,1,-0.0,1
"['1010001', '0', '00001']",13,4,9,0.3076923076923077,0.6923076923076923,0,3,0.8904916402194913,1
['01'],2,1,1,0.5,0.5,0,0,1.0,1
"['11', '00', '1010', '1', '01100']",14,7,7,0.5,0.5,2,2,1.0,0
"['0000', '111']",7,3,4,0.4285714285714285,0.5714285714285714,1,2,0.9852281360342516,1
"['1111', '111', '0000', '1101', '110100']",21,13,8,0.6190476190476191,0.3809523809523809,5,3,0.9587118829771318,0
"['0', '1011', '00', '01111', '1101', '1000', '00100', '1', '000100']",32,14,18,0.4375,0.5625,5,6,0.9886994082884974,0
"['0001100', '01001', '01011', '1000', '10']",23,9,14,0.391304347826087,0.6086956521739131,2,4,0.9656361333706098,1
"['100', '110101', '111101']",15,10,5,0.6666666666666666,0.3333333333333333,3,1,0.9182958340544896,1
"['1111', '100', '11', '1', '110011', '1', '01', '0100', '10', '01']",27,17,10,0.6296296296296297,0.3703703703703703,5,4,0.9509560484549724,0
"['1011011', '11010', '1110010', '101001', '0110100']",32,18,14,0.5625,0.4375,5,3,0.9886994082884974,1
"['101', '1100', '10', '011', '01011', '00100', '01011', '00', '1110101', '11111']",41,24,17,0.5853658536585366,0.4146341463414634,8,5,0.9788698505067784,0
['10001'],5,2,3,0.4,0.6,0,1,0.9709505944546686,1
['0'],1,0,1,0.0,1.0,0,0,-0.0,1
"['100', '011', '0010', '100101']",16,7,9,0.4375,0.5625,1,3,0.9886994082884974,1
"['1100', '0', '0']",6,2,4,0.3333333333333333,0.6666666666666666,1,2,0.9182958340544896,1
"['01', '000100', '11101', '100110', '010100', '1010000', '0011111']",39,18,21,0.4615384615384615,0.5384615384615384,5,8,0.9957274520849256,1
"['111', '0001']",7,4,3,0.5714285714285714,0.4285714285714285,1,1,0.9852281360342516,1
"['1111001', '1010011', '001', '011', '0001100']",27,14,13,0.5185185185185185,0.4814814814814814,6,5,0.9990102708804812,1
"['1010010', '0', '1', '1', '000', '101100', '11', '100000', '1101']",31,14,17,0.4516129032258064,0.5483870967741935,4,6,0.9932338197397066,0
"['0000101', '10', '0000', '000']",16,3,13,0.1875,0.8125,1,6,0.6962122601251458,0
"['00000', '00', '1', '01011', '000', '110', '01110', '0101000', '00110']",36,13,23,0.3611111111111111,0.6388888888888888,4,8,0.943601631299382,0
"['010', '10', '1110101', '11000', '1111', '1100', '1', '0100', '1', '0000010']",38,19,19,0.5,0.5,5,5,1.0,0
"['111', '1110', '010', '01110', '11111', '11', '0010', '11100']",31,21,10,0.6774193548387096,0.3225806451612903,8,4,0.907165767573082,0
"['010001', '0', '1000001', '111', '0001', '01', '1001', '001']",30,12,18,0.4,0.6,3,6,0.9709505944546686,0
"['00101', '111000', '1001', '1', '010', '011100', '100101', '11000', '0110', '00']",42,19,23,0.4523809523809524,0.5476190476190477,6,9,0.9934472383802028,0
"['0001100', '0', '1011000', '11000', '01111', '10000', '01111', '111100', '11', '11000']",48,24,24,0.5,0.5,11,9,1.0,0
['1'],1,1,0,1.0,0.0,0,0,-0.0,1
"['0100111', '1011101', '111', '001', '1000']",24,14,10,0.5833333333333334,0.4166666666666667,6,3,0.9798687566511528,1
"['101', '1']",4,3,1,0.75,0.25,1,0,0.8112781244591328,1
"['1', '1', '000001']",8,3,5,0.375,0.625,1,2,0.954434002924965,1
"['0', '1', '10', '00010', '010011', '01011', '00', '11']",24,11,13,0.4583333333333333,0.5416666666666666,4,5,0.99498482818597,0
"['0011', '100101', '0', '0', '001', '101', '00110', '10', '1111', '0011010']",36,18,18,0.5,0.5,6,6,1.0,0
"['1110', '00000', '10011', '100111', '10000', '001', '1']",29,13,16,0.4482758620689655,0.5517241379310345,5,8,0.9922666387194964,0
"['1010110', '010', '0011001', '00000', '111111', '0001']",32,15,17,0.46875,0.53125,5,6,0.9971803988942642,1
['0011010'],7,3,4,0.4285714285714285,0.5714285714285714,1,1,0.9852281360342516,1
"['101110', '111', '10100']",14,9,5,0.6428571428571429,0.3571428571428571,3,1,0.9402859586706313,1
"['10', '010', '01011', '0000', '0111010', '1101', '1110110', '0110100']",39,20,19,0.5128205128205128,0.4871794871794871,7,6,0.999525689293649,0
"['010001', '100', '1001100', '101001']",22,9,13,0.4090909090909091,0.5909090909090909,2,5,0.9760206482366148,1
"['111001', '1100', '0', '11010', '100010', '00110', '0111110', '1001']",38,20,18,0.5263157894736842,0.4736842105263157,6,6,0.9980008838722996,0
"['10110', '1', '111011', '1', '1', '100', '11', '101110']",25,18,7,0.72,0.28,7,1,0.8554508105601306,0
"['1', '10', '0010100', '0110', '111']",17,9,8,0.5294117647058824,0.4705882352941176,3,2,0.9975025463691152,0
"['1010111', '011000']",13,7,6,0.5384615384615384,0.4615384615384615,2,1,0.9957274520849256,1
"['000', '0000110', '1010101', '00', '0000011', '0001000', '0', '111', '11000', '0']",43,14,29,0.3255813953488372,0.6744186046511628,4,11,0.9103480624345152,0
"['01011', '01111', '10010', '100']",18,10,8,0.5555555555555556,0.4444444444444444,3,2,0.9910760598382222,1
"['0111100', '0', '11', '0']",11,6,5,0.5454545454545454,0.4545454545454545,3,1,0.9940302114769564,0
"['1110', '0001110', '110', '010001']",20,10,10,0.5,0.5,3,4,1.0,1
"['0010', '0001']",8,2,6,0.25,0.75,0,3,0.8112781244591328,1
"['0010', '0', '1']",6,2,4,0.3333333333333333,0.6666666666666666,0,2,0.9182958340544896,0
"['011', '011010', '1111', '00111', '010100', '1100', '0110111', '1000011']",42,24,18,0.5714285714285714,0.4285714285714285,10,5,0.9852281360342516,1
"['0000', '00100', '00110', '011010']",20,6,14,0.3,0.7,2,6,0.8812908992306927,1
"['01101', '00', '0', '10']",10,4,6,0.4,0.6,1,1,0.9709505944546686,0
"['11000', '110', '1111', '1', '0', '100', '01101', '01010', '010', '0']",31,16,15,0.5161290322580645,0.4838709677419355,5,4,0.9992492479956564,0
"['11', '111', '11001']",10,8,2,0.8,0.2,3,1,0.7219280948873623,0
['1'],1,1,0,1.0,0.0,0,0,-0.0,1
"['011001', '1', '0110', '1100', '1100010', '1001', '111']",29,16,13,0.5517241379310345,0.4482758620689655,7,4,0.9922666387194964,0
"['101', '0111', '0', '1', '11010', '10', '000100', '1110111']",29,17,12,0.5862068965517241,0.4137931034482758,4,3,0.9784493292686188,0
"['0', '0010', '10', '110010']",13,5,8,0.3846153846153846,0.6153846153846154,1,2,0.961236604722876,0
"['0010010', '010', '0', '11', '100111', '100', '00']",24,10,14,0.4166666666666667,0.5833333333333334,3,7,0.9798687566511528,0
"['00110', '0110', '1011', '1', '1100', '11100', '1', '011001', '0', '0']",32,17,15,0.53125,0.46875,6,6,0.9971803988942642,0
"['11100', '0']",6,3,3,0.5,0.5,1,1,1.0,1
"['001111', '01001', '010', '11']",16,9,7,0.5625,0.4375,3,2,0.9886994082884974,1
['0'],1,0,1,0.0,1.0,0,0,-0.0,1
"['01111', '00', '0', '0101100', '011', '1110110', '1101000', '111', '1101111', '1']",43,27,16,0.627906976744186,0.3720930232558139,11,4,0.9522656254366642,0
"['010', '0', '01011']",9,4,5,0.4444444444444444,0.5555555555555556,1,1,0.9910760598382222,1
"['1', '0', '0101']",6,3,3,0.5,0.5,0,1,1.0,0
"['00000', '0010', '0000']",13,1,12,0.0769230769230769,0.9230769230769232,0,5,0.3912435636292556,0
"['111001', '0010']",10,5,5,0.5,0.5,1,2,1.0,1
"['0', '11001', '01', '1111000', '0', '1100000', '0110']",27,12,15,0.4444444444444444,0.5555555555555556,5,6,0.9910760598382222,0
"['1111011', '00011']",12,8,4,0.6666666666666666,0.3333333333333333,4,1,0.9182958340544896,1
"['1001', '000001', '000', '1001', '1001100', '1001111', '111100', '1101111']",44,23,21,0.5227272727272727,0.4772727272727273,9,9,0.9985090989176322,1
['010000'],6,1,5,0.1666666666666666,0.8333333333333334,0,2,0.6500224216483541,1
"['0011', '01', '011110', '100000', '1001', '0011', '1011', '11101', '000', '100010']",44,21,23,0.4772727272727273,0.5227272727272727,6,7,0.9985090989176322,0
"['0000100', '1']",8,2,6,0.25,0.75,0,3,0.8112781244591328,1
"['1011', '0000001']",11,4,7,0.3636363636363636,0.6363636363636364,1,3,0.94566030460064,1
"['1001', '11100', '101', '001101', '0']",19,10,9,0.5263157894736842,0.4736842105263157,3,3,0.9980008838722996,1
"['100100', '01', '110001']",14,6,8,0.4285714285714285,0.5714285714285714,1,3,0.9852281360342516,1
['0'],1,0,1,0.0,1.0,0,0,-0.0,1
"['1000101', '0101100']",14,6,8,0.4285714285714285,0.5714285714285714,1,2,0.9852281360342516,1
['1'],1,1,0,1.0,0.0,0,0,-0.0,1
"['010000', '00', '101000', '011', '111', '0010']",24,9,15,0.375,0.625,2,6,0.954434002924965,1
"['111000', '10', '1100', '1', '1010011', '0111000', '0000', '110001', '0010', '0110001']",48,21,27,0.4375,0.5625,7,10,0.9886994082884974,0
"['01', '011', '1010000', '100001']",18,7,11,0.3888888888888889,0.6111111111111112,1,4,0.964078764808229,1
"['100', '111']",6,4,2,0.6666666666666666,0.3333333333333333,1,1,0.9182958340544896,1
"['01', '001001', '101000', '1110', '0010']",22,9,13,0.4090909090909091,0.5909090909090909,2,4,0.9760206482366148,0
"['0000', '0010101', '0101']",15,5,10,0.3333333333333333,0.6666666666666666,0,3,0.9182958340544896,1
"['1110011', '111', '10', '01', '1001110', '100']",24,15,9,0.625,0.375,6,4,0.954434002924965,0
"['000', '000111', '1', '0110001', '01', '1111000', '1101000', '1', '1']",35,17,18,0.4857142857142857,0.5142857142857142,7,6,0.9994110647387552,0
"['0010101', '0100000', '0']",15,4,11,0.2666666666666666,0.7333333333333333,0,4,0.8366407419411672,1
['101'],3,2,1,0.6666666666666666,0.3333333333333333,0,0,0.9182958340544896,1
"['101', '11', '001101', '001001', '100111', '0000000', '01010', '101', '010']",41,18,23,0.4390243902439024,0.5609756097560976,4,8,0.9892452969285004,0
"['0', '010', '1', '01', '1111', '001101', '1010', '0011', '000110']",31,16,15,0.5161290322580645,0.4838709677419355,6,4,0.9992492479956564,0
"['101111', '101', '1', '01']",12,9,3,0.75,0.25,3,0,0.8112781244591328,0
"['1', '01', '10111', '101', '1011001']",18,12,6,0.6666666666666666,0.3333333333333333,5,1,0.9182958340544896,0
"['1', '0', '0', '01', '0', '0001']",10,3,7,0.3,0.7,0,3,0.8812908992306927,0
"['00101', '0000100']",12,3,9,0.25,0.75,0,4,0.8112781244591328,1
"['01011', '1100', '0100', '10', '0', '0110101', '1111', '01']",29,16,13,0.5517241379310345,0.4482758620689655,5,3,0.9922666387194964,0
"['1011', '10', '101', '0', '101001', '0100', '0100100', '11']",29,14,15,0.4827586206896552,0.5172413793103449,2,4,0.9991421039919088,0
"['111011', '0', '10110', '0100011', '101110', '10']",27,16,11,0.5925925925925926,0.4074074074074074,5,2,0.975119064940866,0
"['0110', '1100010', '100010', '0', '0011110', '11', '0', '0', '11', '111']",34,18,16,0.5294117647058824,0.4705882352941176,7,5,0.9975025463691152,0
['0110'],4,2,2,0.5,0.5,1,0,1.0,1
"['11000', '111011', '1101', '101001', '111', '1100011', '111011']",37,25,12,0.6756756756756757,0.3243243243243243,11,3,0.9090221560878148,1
"['01', '0', '0000', '1011101', '110100', '11100', '011', '00100']",33,15,18,0.4545454545454545,0.5454545454545454,4,6,0.9940302114769564,0
"['10011', '01', '0', '000', '1100100', '1', '0', '010010', '001011']",32,13,19,0.40625,0.59375,3,8,0.9744894033980523,0
"['010100', '0001', '0', '00001', '1111', '101']",23,10,13,0.4347826086956521,0.5652173913043478,3,4,0.9876925088958034,0
"['00010', '1101111', '1100', '1000111', '1000010', '10', '10010', '001000', '11', '0001']",49,22,27,0.4489795918367347,0.5510204081632653,7,9,0.992476003943082,0
"['0011', '010']",7,3,4,0.4285714285714285,0.5714285714285714,1,1,0.9852281360342516,1
"['100', '00', '101100', '0000', '01', '01101', '11', '0', '1110101', '011011']",38,19,19,0.5,0.5,6,5,1.0,0
['100111'],6,4,2,0.6666666666666666,0.3333333333333333,1,1,0.9182958340544896,1
"['1', '000111', '00110', '00', '0011111', '011110']",27,15,12,0.5555555555555556,0.4444444444444444,6,4,0.9910760598382222,0
['11'],2,2,0,1.0,0.0,1,0,-0.0,1
"['00', '1', '0111', '1000', '001000', '01', '100011', '00100', '1']",31,12,19,0.3870967741935484,0.6129032258064516,4,8,0.9629004147713268,0
"['110', '1111111', '1010', '11101', '110', '011110', '10', '000101']",36,24,12,0.6666666666666666,0.3333333333333333,9,3,0.9182958340544896,0
"['0', '00', '1100', '001']",10,3,7,0.3,0.7,1,3,0.8812908992306927,0
"['1', '00001', '1001111', '10000', '1000011', '0010', '10110']",34,15,19,0.4411764705882353,0.5588235294117647,5,8,0.9899927915575186,0
"['1111', '00', '1110001']",13,8,5,0.6153846153846154,0.3846153846153846,3,2,0.961236604722876,1
"['001001', '1', '01001']",12,5,7,0.4166666666666667,0.5833333333333334,1,3,0.9798687566511528,1
"['001111', '0100', '10100', '101111', '010010', '1110', '0101', '1111000']",42,23,19,0.5476190476190477,0.4523809523809524,7,6,0.9934472383802028,1
"['01', '00000', '01', '01000', '0', '001', '000', '00010', '10101', '1011']",35,11,24,0.3142857142857143,0.6857142857142857,2,9,0.898058793450166,0
"['1', '011011', '10', '1100', '0011', '1101011', '1', '00']",27,16,11,0.5925925925925926,0.4074074074074074,6,3,0.975119064940866,0
"['111101', '00']",8,5,3,0.625,0.375,2,1,0.954434002924965,1
"['1101', '01', '01110']",11,7,4,0.6363636363636364,0.3636363636363636,2,0,0.94566030460064,1
"['0000', '0000', '01', '0']",11,1,10,0.0909090909090909,0.9090909090909092,0,4,0.4394969869215134,0
"['0', '10100', '0', '101']",10,4,6,0.4,0.6,0,1,0.9709505944546686,0
"['010101', '1', '110000', '10', '0']",16,7,9,0.4375,0.5625,2,3,0.9886994082884974,0
"['001', '100', '1110', '1011110', '101', '101110', '1100']",30,18,12,0.6,0.4,7,3,0.9709505944546686,0
"['1011', '101011', '0110', '01101', '1101', '0', '0010111', '011010', '0100111', '0010000']",51,27,24,0.5294117647058824,0.4705882352941176,8,7,0.9975025463691152,0
"['1', '00', '101', '10101']",11,6,5,0.5454545454545454,0.4545454545454545,1,1,0.9940302114769564,1
"['1', '001', '1011101', '110', '0', '01', '0000100']",24,11,13,0.4583333333333333,0.5416666666666666,3,5,0.99498482818597,0
"['110110', '0101']",10,6,4,0.6,0.4,2,1,0.9709505944546686,1
['0001101'],7,3,4,0.4285714285714285,0.5714285714285714,1,1,0.9852281360342516,1
"['100101', '00001']",11,4,7,0.3636363636363636,0.6363636363636364,0,3,0.94566030460064,1
"['1', '1110000', '0001001', '111011', '0011', '001101', '010', '11010', '1', '00']",42,21,21,0.5,0.5,8,7,1.0,0
"['1101011', '1010111']",14,10,4,0.7142857142857143,0.2857142857142857,3,0,0.863120568566631,1
"['11111', '11001', '0110', '11000', '11011', '011011', '0100011', '0100', '000']",44,24,20,0.5454545454545454,0.4545454545454545,10,5,0.9940302114769564,0
"['0', '101110', '10001']",12,6,6,0.5,0.5,1,1,1.0,1
"['11', '11']",4,4,0,1.0,0.0,2,0,-0.0,1
"['10', '1000', '10', '1101100', '000011', '01101']",26,12,14,0.4615384615384615,0.5384615384615384,4,4,0.9957274520849256,1
"['01111', '10111', '010', '000', '0000', '001011', '00', '01', '1101']",34,16,18,0.4705882352941176,0.5294117647058824,5,6,0.9975025463691152,0
"['10', '0101']",6,3,3,0.5,0.5,0,1,1.0,1
"['0010', '001001', '0001100', '001001', '11101', '1101100']",35,15,20,0.4285714285714285,0.5714285714285714,5,8,0.9852281360342516,1
"['0', '11', '100', '0', '000', '000']",13,3,10,0.2307692307692307,0.7692307692307693,1,4,0.7793498372920851,0
"['0101011', '001', '111']",13,8,5,0.6153846153846154,0.3846153846153846,3,1,0.961236604722876,1
"['0000', '1110101', '0110110', '101111']",24,14,10,0.5833333333333334,0.4166666666666667,5,2,0.9798687566511528,1
"['011', '01011', '1011', '10', '110', '0', '10']",20,12,8,0.6,0.4,4,1,0.9709505944546686,0
"['0101', '00111', '111000', '0110', '1']",20,11,9,0.55,0.45,4,3,0.9927744539878084,1
"['101100', '010000', '0100', '000001', '01', '11100', '0001']",33,11,22,0.3333333333333333,0.6666666666666666,3,8,0.9182958340544896,0
"['01', '111', '101001', '110010', '1101001', '1111', '111']",31,21,10,0.6774193548387096,0.3225806451612903,8,3,0.907165767573082,0
"['0', '00001', '000110', '111011']",18,8,10,0.4444444444444444,0.5555555555555556,3,3,0.9910760598382222,1
"['111110', '010010', '1011110', '1011', '001110', '0', '1001001']",37,21,16,0.5675675675675675,0.4324324324324324,6,6,0.9867867202680318,0
['0100000'],7,1,6,0.1428571428571428,0.8571428571428571,0,2,0.5916727785823275,1
['1'],1,1,0,1.0,0.0,0,0,-0.0,1
"['1', '11011']",6,5,1,0.8333333333333334,0.1666666666666666,2,0,0.6500224216483541,1
"['011001', '00000']",11,3,8,0.2727272727272727,0.7272727272727273,1,3,0.8453509366224364,1
['0100'],4,1,3,0.25,0.75,0,1,0.8112781244591328,1
"['01111', '000011', '01', '01', '0000', '10111', '00']",26,12,14,0.4615384615384615,0.5384615384615384,4,5,0.9957274520849256,0
"['1011101', '1011001', '1111', '01', '10000', '11', '110', '0']",31,19,12,0.6129032258064516,0.3870967741935484,8,4,0.9629004147713268,0
"['1110', '1010', '00', '0', '00', '10']",15,6,9,0.4,0.6,1,3,0.9709505944546686,0
"['1011', '100010', '1', '0']",12,6,6,0.5,0.5,1,1,1.0,0
"['11100', '1110', '0']",10,6,4,0.6,0.4,2,2,0.9709505944546686,0
"['111', '1000', '0001', '1110100', '001']",21,10,11,0.4761904761904761,0.5238095238095238,4,5,0.998363672593813,1
"['01011', '101', '1010', '001', '1000', '1110']",23,12,11,0.5217391304347826,0.4782608695652174,4,2,0.9986359641585718,1
"['101', '101101']",9,6,3,0.6666666666666666,0.3333333333333333,2,0,0.9182958340544896,0
"['010101', '10010', '00000', '01', '0101010', '0', '0', '01001', '0101101']",39,15,24,0.3846153846153846,0.6153846153846154,2,7,0.961236604722876,0
"['0101010', '11', '101000', '11', '1110', '01']",23,13,10,0.5652173913043478,0.4347826086956521,3,2,0.9876925088958034,1
"['0', '11', '111101', '100', '010', '01010']",20,11,9,0.55,0.45,4,2,0.9927744539878084,0
"['10111', '1', '100']",9,6,3,0.6666666666666666,0.3333333333333333,2,1,0.9182958340544896,1
"['000001', '010', '0']",10,2,8,0.2,0.8,0,3,0.7219280948873623,0
"['010100', '1', '0100101', '11', '00000', '0110011']",28,12,16,0.4285714285714285,0.5714285714285714,3,6,0.9852281360342516,0
"['1000111', '1', '0001110', '1001000', '01', '1', '110101', '101010', '00100']",42,20,22,0.4761904761904761,0.5238095238095238,6,7,0.998363672593813,0
['00'],2,0,2,0.0,1.0,0,1,-0.0,1
"['111', '00110', '0000100', '110', '100111', '00', '11110', '10', '0011001']",40,20,20,0.5,0.5,7,8,1.0,0
"['00011', '11', '00']",9,4,5,0.4444444444444444,0.5555555555555556,2,2,0.9910760598382222,1
"['00111', '100111', '1', '1110', '011', '1111', '1110', '00000', '01111', '101000']",43,26,17,0.6046511627906976,0.3953488372093023,11,7,0.9681647320759544,0
"['1011', '111']",7,6,1,0.8571428571428571,0.1428571428571428,2,0,0.5916727785823275,1
"['01', '0111', '0101', '1100', '0', '00', '11110']",22,12,10,0.5454545454545454,0.4545454545454545,4,2,0.9940302114769564,0
"['01010', '1100', '1', '01011', '01001']",20,10,10,0.5,0.5,2,2,1.0,1
"['11000', '111011', '1001111', '110', '0111', '1000000', '110000', '11000']",43,22,21,0.5116279069767442,0.4883720930232558,10,9,0.999609836367807,1
"['01000', '110', '0110111', '10101', '000', '11', '10100', '001']",33,16,17,0.4848484848484848,0.5151515151515151,5,5,0.9993375041688848,0
"['0000', '1', '0010', '001111', '0110011']",22,10,12,0.4545454545454545,0.5454545454545454,4,5,0.9940302114769564,1
"['0101', '111', '000011', '11010']",18,10,8,0.5555555555555556,0.4444444444444444,4,2,0.9910760598382222,1
"['101100', '01', '00011', '0010']",17,7,10,0.4117647058823529,0.5882352941176471,2,3,0.9774178175281716,1
"['10001', '110001', '11', '110', '110110', '011', '000011', '1110111', '1']",39,24,15,0.6153846153846154,0.3846153846153846,10,5,0.961236604722876,0
"['11111', '0011', '0', '10111', '0110', '00010', '10111', '1', '01110', '010']",38,23,15,0.6052631578947368,0.3947368421052631,8,4,0.9677884628267678,0
"['11', '0', '1', '0001101', '1110100', '1010', '100', '01', '000']",30,14,16,0.4666666666666667,0.5333333333333333,4,4,0.9967916319816366,0
"['010', '1000010', '100100', '000011']",22,7,15,0.3181818181818182,0.6818181818181818,1,6,0.9023932827949788,1
"['1100', '111101', '101001', '10101', '00', '0100', '0000', '1011', '00001']",40,18,22,0.45,0.55,6,8,0.9927744539878084,0
"['01', '0', '0100', '110101', '0', '011011', '10001', '1110001', '001100', '0']",39,18,21,0.4615384615384615,0.5384615384615384,6,7,0.9957274520849256,0
"['1101', '0']",5,3,2,0.6,0.4,1,0,0.9709505944546686,1
"['0100', '1111', '0001', '01', '010']",17,8,9,0.4705882352941176,0.5294117647058824,2,2,0.9975025463691152,0
"['0', '1', '00', '0111', '100', '011000', '00110', '00011', '0110']",31,13,18,0.4193548387096774,0.5806451612903226,6,6,0.9811522341999132,0
"['1011', '100', '1101101', '10110', '10']",21,13,8,0.6190476190476191,0.3809523809523809,5,1,0.9587118829771318,0
"['00', '1111101', '000', '101']",15,8,7,0.5333333333333333,0.4666666666666667,2,2,0.9967916319816366,0
"['00101', '10101', '00111', '1', '100101', '001', '0011', '101', '01']",34,18,16,0.5294117647058824,0.4705882352941176,4,5,0.9975025463691152,0
"['1001010', '1001', '101', '1001001', '00']",23,10,13,0.4347826086956521,0.5652173913043478,2,5,0.9876925088958034,0
"['0110', '0101', '0', '1', '1110', '10110', '1110110', '0111', '0', '10']",33,20,13,0.6060606060606061,0.3939393939393939,7,2,0.9672947789468944,0
"['1010001', '00', '1', '111111', '11101', '001', '11', '1', '000111']",33,21,12,0.6363636363636364,0.3636363636363636,8,4,0.94566030460064,0
"['0110', '0']",5,2,3,0.4,0.6,1,1,0.9709505944546686,1
"['001101', '0', '101', '00', '1110011', '1101010', '00111', '1101001', '01', '0010111']",47,26,21,0.5531914893617021,0.4468085106382978,7,6,0.9918207974218424,0
"['1111011', '001110', '1', '0101', '110', '110', '011100']",30,19,11,0.6333333333333333,0.3666666666666666,7,3,0.9480782435939056,0
"['11111', '11100', '01001', '10100', '100', '100', '1010', '0100']",34,17,17,0.5,0.5,5,7,1.0,0
"['01101', '1', '11', '10010']",13,8,5,0.6153846153846154,0.3846153846153846,3,1,0.961236604722876,0
"['0', '011011', '1011010', '011111', '100']",23,14,9,0.6086956521739131,0.391304347826087,6,3,0.9656361333706098,1
"['1000111', '0100100', '111', '0011']",21,11,10,0.5238095238095238,0.4761904761904761,3,4,0.998363672593813,1
['010111'],6,4,2,0.6666666666666666,0.3333333333333333,1,0,0.9182958340544896,1
"['001', '00', '10010', '0', '000', '1', '0100', '111100', '0011100', '00']",34,12,22,0.3529411764705882,0.6470588235294118,3,10,0.9366673818775626,0
"['00011', '0', '1010101', '00100', '0001001']",25,9,16,0.36,0.64,1,5,0.9426831892554922,1
"['1', '110110', '01100', '11111', '110011', '101', '01101']",31,21,10,0.6774193548387096,0.3225806451612903,8,3,0.907165767573082,0
"['10', '0001', '1', '10', '1110100']",16,8,8,0.5,0.5,2,3,1.0,1
"['100111', '010010', '0']",13,6,7,0.4615384615384615,0.5384615384615384,1,3,0.9957274520849256,1
"['1', '11001', '110100', '1', '11001', '100101']",24,14,10,0.5833333333333334,0.4166666666666667,4,4,0.9798687566511528,1
"['00010', '111', '011', '1110111', '101100', '0']",25,15,10,0.6,0.4,6,2,0.9709505944546686,0
"['111', '01010']",8,5,3,0.625,0.375,1,0,0.954434002924965,1
"['1010', '001', '00010', '011']",15,6,9,0.4,0.6,1,3,0.9709505944546686,1
"['011', '000', '10110', '01111', '111', '101', '1010010', '0111111', '01']",38,24,14,0.631578947368421,0.3684210526315789,10,4,0.9494520153879484,0
"['101110', '1', '110', '1111011']",17,13,4,0.7647058823529411,0.2352941176470588,5,0,0.7871265862012691,0
"['110', '100001', '1010', '1011', '1', '0110001', '0001']",29,14,15,0.4827586206896552,0.5172413793103449,4,4,0.9991421039919088,0
"['01100', '1', '00011', '1000', '110', '1100011', '0100']",29,13,16,0.4482758620689655,0.5517241379310345,5,5,0.9922666387194964,0
"['01111', '1111']",9,8,1,0.8888888888888888,0.1111111111111111,4,0,0.5032583347756457,1
"['0', '1', '1']",3,2,1,0.6666666666666666,0.3333333333333333,1,0,0.9182958340544896,1
"['10000', '0101', '0', '011', '0001', '1', '010', '0110', '000']",28,10,18,0.3571428571428571,0.6428571428571429,3,7,0.9402859586706313,0
"['110000', '000001', '10100', '10', '01', '001']",24,8,16,0.3333333333333333,0.6666666666666666,2,7,0.9182958340544896,0
['1011'],4,3,1,0.75,0.25,1,0,0.8112781244591328,1
"['0101001', '000', '0000000', '0', '111110', '111011', '0010010', '001001']",43,17,26,0.3953488372093023,0.6046511627906976,4,10,0.9681647320759544,0
"['0', '100', '0111011', '000111', '100111', '100', '100010', '001001']",38,18,20,0.4736842105263157,0.5263157894736842,6,7,0.9980008838722996,0
"['0', '011110', '011']",10,6,4,0.6,0.4,3,2,0.9709505944546686,1
"['01011', '111', '00011', '0111100', '1010']",24,14,10,0.5833333333333334,0.4166666666666667,5,2,0.9798687566511528,1
"['11', '10000', '00', '011', '000010', '1', '1000100', '10', '0100']",32,11,21,0.34375,0.65625,3,9,0.9283620723948676,0
"['010001', '0101', '1', '0011', '11', '110', '0']",21,11,10,0.5238095238095238,0.4761904761904761,4,3,0.998363672593813,0
['111'],3,3,0,1.0,0.0,1,0,-0.0,1
"['0', '0111110', '0', '101100']",15,8,7,0.5333333333333333,0.4666666666666667,3,3,0.9967916319816366,1
"['101', '0000111', '00010', '100111', '01001', '0100101', '0011', '10', '010', '1100']",46,21,25,0.4565217391304347,0.5434782608695652,4,9,0.994538681650011,0
"['1', '110101', '10000', '110101']",18,10,8,0.5555555555555556,0.4444444444444444,3,2,0.9910760598382222,1
"['010101', '011000', '00010', '1010', '111011', '101', '1', '1010010']",38,19,19,0.5,0.5,4,4,1.0,0
"['0100111', '00', '0110011', '1', '011000', '0011']",27,13,14,0.4814814814814814,0.5185185185185185,5,5,0.9990102708804812,0
['100111'],6,4,2,0.6666666666666666,0.3333333333333333,1,1,0.9182958340544896,1
"['0010010', '111', '011011']",16,9,7,0.5625,0.4375,3,2,0.9886994082884974,1
"['11001', '10']",7,4,3,0.5714285714285714,0.4285714285714285,2,1,0.9852281360342516,1
"['1', '01100']",6,3,3,0.5,0.5,1,1,1.0,1
"['0', '101001', '1', '1001', '0001110', '1100', '101000', '1', '0']",31,14,17,0.4516129032258064,0.5483870967741935,3,5,0.9932338197397066,0
"['100011', '1010001']",13,6,7,0.4615384615384615,0.5384615384615384,1,2,0.9957274520849256,1
"['000', '11001', '001', '1', '0', '1', '111101', '0110', '0010101']",31,16,15,0.5161290322580645,0.4838709677419355,5,4,0.9992492479956564,0
['01010'],5,2,3,0.4,0.6,0,0,0.9709505944546686,1
"['1010111', '11', '11000', '0100', '0', '0110110', '10', '01000', '10000']",38,17,21,0.4473684210526316,0.5526315789473685,5,8,0.9919924034538556,0
"['110', '000', '1110', '101', '010']",16,8,8,0.5,0.5,2,2,1.0,1
"['0', '001100', '110', '11']",12,6,6,0.5,0.5,3,2,1.0,0
"['0000001', '0', '11100', '0', '1011']",18,7,11,0.3888888888888889,0.6111111111111112,2,4,0.964078764808229,1
"['0110', '0110011', '11110', '11000', '00011', '01100', '1111', '00', '11']",39,22,17,0.5641025641025641,0.4358974358974359,11,7,0.98811083652183,0
"['10', '0011', '1', '011100', '1110', '1001']",21,12,9,0.5714285714285714,0.4285714285714285,3,3,0.9852281360342516,0
"['011', '100011', '1', '110111', '0', '0', '0111111']",25,17,8,0.68,0.32,7,2,0.9043814577244936,0
"['000110', '10', '111', '0001000', '1010']",22,9,13,0.4090909090909091,0.5909090909090909,2,3,0.9760206482366148,0
"['010', '000', '1111', '000', '101111', '11', '00100', '01']",28,14,14,0.5,0.5,5,5,1.0,0
"['0101010', '1100', '010', '1']",15,7,8,0.4666666666666667,0.5333333333333333,1,1,0.9967916319816366,0
"['011011', '11101', '1', '00011', '101000', '00010', '0110101']",35,18,17,0.5142857142857142,0.4857142857142857,6,5,0.9994110647387552,0
"['01', '1100', '1001', '011', '111', '11', '01', '011']",23,15,8,0.6521739130434783,0.3478260869565217,5,2,0.9321115676166748,0
"['0111', '0', '10', '1000011', '00101', '0001', '1000', '01']",29,12,17,0.4137931034482758,0.5862068965517241,3,6,0.9784493292686188,0
"['11', '1000', '11111', '000', '000111']",20,11,9,0.55,0.45,4,4,0.9927744539878084,0
['0110001'],7,3,4,0.4285714285714285,0.5714285714285714,1,1,0.9852281360342516,1
"['01', '001', '010111', '1110110', '1000100', '010111', '000001', '1', '11']",40,21,19,0.525,0.475,7,5,0.99819587904281,0
['0'],1,0,1,0.0,1.0,0,0,-0.0,1
"['1101', '110', '100', '110', '00', '0', '1111110', '10', '0001000', '011']",35,18,17,0.5142857142857142,0.4857142857142857,7,7,0.9994110647387552,0
"['11', '0111', '0010', '0000011']",17,8,9,0.4705882352941176,0.5294117647058824,3,4,0.9975025463691152,1
"['100100', '01111', '0110000', '000100', '1011']",28,12,16,0.4285714285714285,0.5714285714285714,4,6,0.9852281360342516,1
"['100110', '110', '01', '1100110', '1', '001011']",25,14,11,0.56,0.44,5,4,0.9895875212220556,0
"['0', '11010', '0111', '0101', '1']",15,9,6,0.6,0.4,3,1,0.9709505944546686,0
"['00000', '11']",7,2,5,0.2857142857142857,0.7142857142857143,1,2,0.863120568566631,1
"['01000', '1', '1111', '1', '111111', '100000', '00', '1', '1']",27,16,11,0.5925925925925926,0.4074074074074074,7,4,0.975119064940866,0
"['00110', '010010', '0111', '0010100', '1', '1011']",27,13,14,0.4814814814814814,0.5185185185185185,4,6,0.9990102708804812,0
"['101', '00', '101']",8,4,4,0.5,0.5,0,1,1.0,1
"['0100', '0000010', '0011101', '10', '001101', '1', '10010', '011111', '01001', '100011']",49,23,26,0.4693877551020408,0.5306122448979592,8,9,0.9972943816462349,0
"['101101', '0', '0110', '01100', '1', '000010']",23,10,13,0.4347826086956521,0.5652173913043478,3,5,0.9876925088958034,0
"['10', '00', '010001']",10,3,7,0.3,0.7,0,3,0.8812908992306927,1
"['001110', '1110', '1101']",14,9,5,0.6428571428571429,0.3571428571428571,3,1,0.9402859586706313,1
['010110'],6,3,3,0.5,0.5,1,0,1.0,1
"['1000100', '001', '01', '010101', '0100100', '110', '00011', '1']",34,14,20,0.4117647058823529,0.5882352941176471,2,7,0.9774178175281716,0
"['010', '1']",4,2,2,0.5,0.5,0,0,1.0,1
"['111011', '110111', '00101', '00', '1']",20,13,7,0.65,0.35,4,2,0.934068055375491,0
"['11011', '11001', '10000', '1']",16,9,7,0.5625,0.4375,4,3,0.9886994082884974,1
"['001', '01110', '00101', '01001', '1011', '1', '010111', '111001']",35,20,15,0.5714285714285714,0.4285714285714285,6,4,0.9852281360342516,0
['0'],1,0,1,0.0,1.0,0,0,-0.0,1
['101'],3,2,1,0.6666666666666666,0.3333333333333333,0,0,0.9182958340544896,1
"['100111', '1101000', '1111010']",20,12,8,0.6,0.4,4,2,0.9709505944546686,1
"['1101', '0100', '1100010', '0110010', '10111', '011', '0010']",34,17,17,0.5,0.5,5,5,1.0,0
"['10011', '110', '0001']",12,6,6,0.5,0.5,2,3,1.0,1
['0011111'],7,5,2,0.7142857142857143,0.2857142857142857,2,1,0.863120568566631,1
"['1011', '10', '00', '110', '10', '1000']",17,8,9,0.4705882352941176,0.5294117647058824,2,2,0.9975025463691152,0
['0100110'],7,3,4,0.4285714285714285,0.5714285714285714,1,1,0.9852281360342516,1
"['1', '1001111', '0', '00', '0001011', '1000']",22,10,12,0.4545454545454545,0.5454545454545454,4,5,0.9940302114769564,0
"['01', '1000011', '111', '1100000', '10', '110101']",27,14,13,0.5185185185185185,0.4814814814814814,5,4,0.9990102708804812,1
"['010', '101100', '11111', '1000101', '000', '1', '101100', '0011001', '0111', '0110110']",49,26,23,0.5306122448979592,0.4693877551020408,10,6,0.9972943816462349,0
"['01010', '10110', '0', '0010', '01']",17,7,10,0.4117647058823529,0.5882352941176471,1,3,0.9774178175281716,0
"['1111', '0', '00', '011', '10', '100000', '001111', '1011', '111010']",34,19,15,0.5588235294117647,0.4411764705882353,7,5,0.9899927915575186,0
"['0', '0010', '111100', '01111', '101011', '1010', '01']",28,16,12,0.5714285714285714,0.4285714285714285,5,3,0.9852281360342516,0
"['1000', '0001', '11001', '000000', '1', '111001', '1101101', '1000001', '1', '0000000']",48,18,30,0.375,0.625,7,13,0.954434002924965,0
"['0101', '0', '0', '100101']",12,5,7,0.4166666666666667,0.5833333333333334,0,2,0.9798687566511528,1
"['1010', '1', '1011', '00', '100', '10111', '0000', '10', '1011']",29,15,14,0.5172413793103449,0.4827586206896552,4,4,0.9991421039919088,0
"['00111', '01', '1111']",11,8,3,0.7272727272727273,0.2727272727272727,3,1,0.8453509366224364,1
"['1', '010001', '11010', '101', '1010', '0111']",23,13,10,0.5652173913043478,0.4347826086956521,3,2,0.9876925088958034,0
"['111', '11', '11111', '01', '1001101']",19,15,4,0.7894736842105263,0.2105263157894736,7,1,0.7424875695421236,0
"['110110', '110', '0010111']",16,10,6,0.625,0.375,4,1,0.954434002924965,0
"['0101100', '100001', '0', '01100', '01110']",24,10,14,0.4166666666666667,0.5833333333333334,3,5,0.9798687566511528,1
"['0011', '10000', '0010', '0111', '110', '1']",21,10,11,0.4761904761904761,0.5238095238095238,3,5,0.998363672593813,0
"['1101001', '00', '011', '011001', '0101111']",25,14,11,0.56,0.44,5,3,0.9895875212220556,1
"['1', '1101010', '1']",9,6,3,0.6666666666666666,0.3333333333333333,1,0,0.9182958340544896,1
"['011', '00', '1010111', '10000', '11', '100110', '1101100', '0', '100']",36,18,18,0.5,0.5,7,6,1.0,0
"['111', '1111', '11', '001', '10010', '1001', '01', '111110', '00000']",34,20,14,0.5882352941176471,0.4117647058823529,8,6,0.9774178175281716,0
"['1', '010', '0011010', '01100', '111101']",22,12,10,0.5454545454545454,0.4545454545454545,4,3,0.9940302114769564,0
"['000', '1111', '0', '101']",11,6,5,0.5454545454545454,0.4545454545454545,2,1,0.9940302114769564,0
"['1', '11', '1', '01']",6,5,1,0.8333333333333334,0.1666666666666666,2,0,0.6500224216483541,0
"['0011011', '100', '011000', '01']",18,8,10,0.4444444444444444,0.5555555555555556,3,4,0.9910760598382222,1
"['01100', '10', '01', '0', '01010', '011110', '0', '01', '000', '11010']",32,14,18,0.4375,0.5625,4,6,0.9886994082884974,0
"['100', '100111']",9,5,4,0.5555555555555556,0.4444444444444444,1,2,0.9910760598382222,1
"['101', '001', '01', '010101', '0', '1011', '001']",22,11,11,0.5,0.5,1,2,1.0,0
"['0110', '0', '1011', '11', '01101', '001']",19,11,8,0.5789473684210527,0.4210526315789473,4,2,0.9819407868640976,0
"['1011', '0110', '111100']",14,9,5,0.6428571428571429,0.3571428571428571,4,1,0.9402859586706313,1
"['1100', '10000', '01', '0000', '0100']",19,5,14,0.2631578947368421,0.7368421052631579,1,6,0.8314743880097293,1
"['00010', '110000', '00110', '000', '1001100', '111001', '001111']",38,16,22,0.4210526315789473,0.5789473684210527,6,10,0.9819407868640976,1
"['1111', '1', '0000']",9,5,4,0.5555555555555556,0.4444444444444444,2,2,0.9910760598382222,0
['0100110'],7,3,4,0.4285714285714285,0.5714285714285714,1,1,0.9852281360342516,1
"['1', '11011', '010', '110000', '1', '111011', '010', '110101', '01001', '1']",37,22,15,0.5945945945945946,0.4054054054054054,8,3,0.974024864435752,0
"['0100111', '1111']",11,8,3,0.7272727272727273,0.2727272727272727,3,1,0.8453509366224364,1
"['0100100', '010', '1', '010110']",17,7,10,0.4117647058823529,0.5882352941176471,1,2,0.9774178175281716,1
['1001'],4,2,2,0.5,0.5,0,1,1.0,1
"['01100', '1001', '0000010', '010', '1', '0110100', '111', '10101']",35,16,19,0.4571428571428571,0.5428571428571428,4,6,0.9946937953613058,0
"['1100100', '1010', '11100', '100', '01001', '01101', '1011', '1111110', '10100', '000']",48,25,23,0.5208333333333334,0.4791666666666667,8,7,0.9987472979361685,0
['1100'],4,2,2,0.5,0.5,1,1,1.0,1
"['1010111', '00']",9,5,4,0.5555555555555556,0.4444444444444444,1,1,0.9910760598382222,1
"['0010', '1', '10110', '1', '00', '111', '000', '00', '0']",22,9,13,0.4090909090909091,0.5909090909090909,3,5,0.9760206482366148,0
"['0010011', '0010', '1100010', '0101101', '1000', '0', '01000', '1001', '1110']",43,18,25,0.4186046511627907,0.5813953488372093,6,9,0.9807983646944296,0
"['110000', '1', '1011']",11,6,5,0.5454545454545454,0.4545454545454545,3,2,0.9940302114769564,1
"['101011', '101', '0010111', '101']",19,12,7,0.631578947368421,0.3684210526315789,3,1,0.9494520153879484,1
"['0000', '100', '00100', '01', '101000', '111', '1010', '10', '1000', '0']",34,12,22,0.3529411764705882,0.6470588235294118,3,8,0.9366673818775626,0
"['0', '1', '10110', '11', '0010100', '0101']",20,10,10,0.5,0.5,3,2,1.0,0
"['100100', '010010', '01100', '0100001', '00101', '010111', '0', '0011100', '00', '01']",47,18,29,0.3829787234042553,0.6170212765957447,3,11,0.9601186626422924,0
['0'],1,0,1,0.0,1.0,0,0,-0.0,1
"['10', '1110', '10', '011', '001', '0010101', '110', '10']",26,14,12,0.5384615384615384,0.4615384615384615,3,3,0.9957274520849256,1
"['0101', '1100']",8,4,4,0.5,0.5,1,1,1.0,1
"['1001', '11111', '100111']",15,11,4,0.7333333333333333,0.2666666666666666,4,2,0.8366407419411672,1
"['0000000', '10000', '0111010', '01', '100', '010']",27,8,19,0.2962962962962963,0.7037037037037037,2,7,0.876716288999464,1
"['010', '100110', '0', '11100', '11', '110', '01011']",25,14,11,0.56,0.44,5,4,0.9895875212220556,0
"['0', '1101', '101001', '0']",12,6,6,0.5,0.5,2,1,1.0,1
"['110100', '10000', '0100110', '1101', '0', '0', '01001']",29,12,17,0.4137931034482758,0.5862068965517241,3,6,0.9784493292686188,0
"['1', '1110', '110', '0011000']",15,8,7,0.5333333333333333,0.4666666666666667,4,2,0.9967916319816366,0
"['0111111', '01000', '010100']",18,9,9,0.5,0.5,3,3,1.0,1
"['001011', '01', '0010001', '10101', '000']",23,9,14,0.391304347826087,0.6086956521739131,2,4,0.9656361333706098,1
"['001', '0010010', '0001000']",17,4,13,0.2352941176470588,0.7647058823529411,0,6,0.7871265862012691,1
"['0101101', '01', '1101', '111000', '10', '01010', '1010', '0101', '001100']",40,20,20,0.5,0.5,5,5,1.0,0
"['111111', '0110100', '00', '110', '000', '1100', '1100']",29,15,14,0.5172413793103449,0.4827586206896552,7,6,0.9991421039919088,0
"['1', '1110010', '0', '101001', '0111011', '110', '0000', '111']",32,18,14,0.5625,0.4375,6,5,0.9886994082884974,0
"['0', '01', '1010', '0110110', '1011011', '1', '1110010', '1010011', '11', '000000']",44,23,21,0.5227272727272727,0.4772727272727273,9,7,0.9985090989176322,0
"['00101', '100011', '0', '1']",13,6,7,0.4615384615384615,0.5384615384615384,2,2,0.9957274520849256,0
"['1', '1', '110110', '1111011']",15,12,3,0.8,0.2,6,0,0.7219280948873623,1
"['011', '001100', '0111101', '1010', '0001', '000000', '0', '00']",33,12,21,0.3636363636363636,0.6363636363636364,5,8,0.94566030460064,0
"['01000', '011110', '000000', '110', '11110', '1110110', '010010', '1000100']",45,20,25,0.4444444444444444,0.5555555555555556,7,9,0.9910760598382222,1
['0101000'],7,2,5,0.2857142857142857,0.7142857142857143,0,1,0.863120568566631,1
"['001', '0111', '0100111', '0101001', '0110', '1001', '01111']",34,19,15,0.5588235294117647,0.4411764705882353,5,4,0.9899927915575186,0
"['000010', '01000', '01', '1110']",17,6,11,0.3529411764705882,0.6470588235294118,2,5,0.9366673818775626,1
"['1110011', '000110', '0101010', '1', '10']",23,12,11,0.5217391304347826,0.4782608695652174,4,3,0.9986359641585718,0
"['10010', '0111', '011000', '0001', '1000', '011', '1101', '0']",31,14,17,0.4516129032258064,0.5483870967741935,5,7,0.9932338197397066,0
"['101', '010000', '10', '1010', '11']",17,8,9,0.4705882352941176,0.5294117647058824,1,2,0.9975025463691152,0
['111'],3,3,0,1.0,0.0,1,0,-0.0,1
"['00', '001', '1100110', '0011001', '001101', '100', '101100', '1001', '0101']",42,19,23,0.4523809523809524,0.5476190476190477,6,9,0.9934472383802028,0
"['0', '1', '00']",4,1,3,0.25,0.75,0,1,0.8112781244591328,0
"['00011', '011001', '1100000', '110', '010101', '0000']",31,12,19,0.3870967741935484,0.6129032258064516,4,7,0.9629004147713268,0
"['10100', '111', '110001', '1010', '110101', '01101', '10', '010']",34,19,15,0.5588235294117647,0.4411764705882353,6,3,0.9899927915575186,0
"['1110', '01', '001', '011']",12,7,5,0.5833333333333334,0.4166666666666667,2,2,0.9798687566511528,1
"['100', '10100', '010110', '0010011', '01011', '110110']",32,16,16,0.5,0.5,5,4,1.0,1
"['1000010', '0']",8,2,6,0.25,0.75,0,3,0.8112781244591328,1
"['0001', '0011', '0111100', '1001101', '0001', '11', '1101111', '1', '0']",37,21,16,0.5675675675675675,0.4324324324324324,8,5,0.9867867202680318,0
"['11100', '0000001', '01111']",17,8,9,0.4705882352941176,0.5294117647058824,3,4,0.9975025463691152,1
"['00110', '0011', '0010', '1', '0', '11', '000110']",23,10,13,0.4347826086956521,0.5652173913043478,4,4,0.9876925088958034,0
"['1000111', '01010', '1001001', '110']",22,11,11,0.5,0.5,2,3,1.0,1
"['0100', '111110', '10001', '01', '1001', '0100', '1', '1', '1011']",31,17,14,0.5483870967741935,0.4516129032258064,5,4,0.9932338197397066,0
"['0', '010101', '00']",9,3,6,0.3333333333333333,0.6666666666666666,0,2,0.9182958340544896,0
['1100'],4,2,2,0.5,0.5,1,1,1.0,1
"['1', '0000', '1100000', '0101', '001001']",22,7,15,0.3181818181818182,0.6818181818181818,1,7,0.9023932827949788,1
"['1111110', '0', '0', '1000', '00100']",18,8,10,0.4444444444444444,0.5555555555555556,3,4,0.9910760598382222,0
['0'],1,0,1,0.0,1.0,0,0,-0.0,1
"['11101', '1110001', '11101', '00', '10']",21,13,8,0.6190476190476191,0.3809523809523809,5,2,0.9587118829771318,1
"['00110', '1001010', '0011110', '011', '101111', '11000', '0000000']",40,18,22,0.45,0.55,7,9,0.9927744539878084,1
"['00100', '0100001', '0', '00011', '00', '1011100', '1', '01100', '0111111']",40,18,22,0.45,0.55,6,9,0.9927744539878084,0
"['010000', '0000', '0', '0111', '00', '1010001', '010001']",30,9,21,0.3,0.7,1,8,0.8812908992306927,0
['0'],1,0,1,0.0,1.0,0,0,-0.0,1
"['1', '01100', '111', '11', '101', '1']",15,11,4,0.7333333333333333,0.2666666666666666,5,1,0.8366407419411672,0
"['111', '110', '100', '1', '100', '1101111', '1100010', '101111', '110']",36,24,12,0.6666666666666666,0.3333333333333333,10,3,0.9182958340544896,0
['111000'],6,3,3,0.5,0.5,1,1,1.0,1
"['010', '10', '0100110', '101']",15,7,8,0.4666666666666667,0.5333333333333333,1,2,0.9967916319816366,0
"['100', '1100001', '10001', '0001010', '0100', '011', '100101', '000', '110110', '11100']",49,21,28,0.4285714285714285,0.5714285714285714,6,10,0.9852281360342516,0
['11011'],5,4,1,0.8,0.2,2,0,0.7219280948873623,1
"['10', '00', '1', '0', '1101', '1']",11,6,5,0.5454545454545454,0.4545454545454545,2,1,0.9940302114769564,0
"['000', '010111', '01', '1110']",15,8,7,0.5333333333333333,0.4666666666666667,3,2,0.9967916319816366,1
"['010110', '1', '110', '1101', '1010000']",21,11,10,0.5238095238095238,0.4761904761904761,4,2,0.998363672593813,0
"['1111001', '00', '111', '000010', '100100', '11000', '1', '01101', '01']",37,18,19,0.4864864864864865,0.5135135135135135,5,7,0.9994730201859836,0
"['00011', '11111']",10,7,3,0.7,0.3,3,1,0.8812908992306927,1
"['1111', '1101', '110111', '00', '1100', '1']",21,15,6,0.7142857142857143,0.2857142857142857,6,2,0.863120568566631,0
"['1', '011', '10', '00', '0000', '1101', '0']",17,7,10,0.4117647058823529,0.5882352941176471,2,3,0.9774178175281716,0
"['011110', '0', '0111100', '11111', '111111', '1', '1', '100101', '010', '1101']",40,28,12,0.7,0.3,12,3,0.8812908992306927,0
"['1', '1', '111', '1011', '1010', '111101', '100101', '0001', '0010']",33,20,13,0.6060606060606061,0.3939393939393939,7,3,0.9672947789468944,0
['1101001'],7,4,3,0.5714285714285714,0.4285714285714285,1,1,0.9852281360342516,1
"['11', '0', '010101', '1001011', '01', '001111']",24,14,10,0.5833333333333334,0.4166666666666667,5,3,0.9798687566511528,0
['0111'],4,3,1,0.75,0.25,1,0,0.8112781244591328,1
"['001001', '1010001', '010000', '101000', '1010011', '110000', '01100', '11011', '111']",51,23,28,0.4509803921568627,0.5490196078431373,7,10,0.9930554830121974,1
"['0', '0', '01', '00', '11', '000011']",14,5,9,0.3571428571428571,0.6428571428571429,2,4,0.9402859586706313,0
['1001'],4,2,2,0.5,0.5,0,1,1.0,1
"['10010', '101100', '11', '10101', '00']",20,10,10,0.5,0.5,2,3,1.0,1
"['1010000', '001', '001110', '100']",19,7,12,0.3684210526315789,0.631578947368421,1,5,0.9494520153879484,1
"['011110', '1110101', '011000', '1000']",23,12,11,0.5217391304347826,0.4782608695652174,4,2,0.9986359641585718,1
"['100', '1', '00', '0000000', '10100', '01', '0111', '000', '00000', '01']",34,9,25,0.2647058823529412,0.7352941176470589,1,10,0.833764907210665,0
['100101'],6,3,3,0.5,0.5,0,1,1.0,1
"['0000', '1', '11', '1100011', '0110', '110111', '1', '1011']",29,18,11,0.6206896551724138,0.3793103448275862,8,3,0.9575534837147482,0
"['1', '1001101', '00111', '00100']",18,9,9,0.5,0.5,3,4,1.0,1
"['01', '1010', '1', '01', '111', '01111']",17,12,5,0.7058823529411765,0.2941176470588235,5,0,0.8739810481273578,0
"['0100110', '1', '1']",9,5,4,0.5555555555555556,0.4444444444444444,2,1,0.9910760598382222,1
"['1', '11111']",6,6,0,1.0,0.0,3,0,-0.0,0
"['0000', '001', '000011']",13,3,10,0.2307692307692307,0.7692307692307693,1,5,0.7793498372920851,1
"['00011', '0100', '0111110', '1010', '0101010', '1110010', '0', '0010001', '10111', '111110']",53,28,25,0.5283018867924528,0.4716981132075472,9,7,0.9976875760352552,0
"['0111', '11', '1100110']",13,9,4,0.6923076923076923,0.3076923076923077,4,1,0.8904916402194913,1
"['1000101', '1000101', '10', '100100', '0110', '0', '0']",28,11,17,0.3928571428571428,0.6071428571428571,3,5,0.9666186325481028,0
"['0', '00', '111', '00111', '111', '11', '0010101', '010', '1101000', '011']",36,20,16,0.5555555555555556,0.4444444444444444,7,5,0.9910760598382222,0
"['1', '011', '1001000', '00', '110001', '111011', '01000']",30,14,16,0.4666666666666667,0.5333333333333333,5,5,0.9967916319816366,0
"['01000', '1', '011', '101111']",15,9,6,0.6,0.4,3,1,0.9709505944546686,0
"['1110', '1010', '0010', '01']",14,7,7,0.5,0.5,1,2,1.0,1
"['010', '100011', '0101101']",16,8,8,0.5,0.5,2,1,1.0,1
"['0000110', '0', '0', '11110', '1', '1110110', '01111']",27,16,11,0.5925925925925926,0.4074074074074074,8,4,0.975119064940866,0
"['01010', '0', '111110', '010001', '01110', '01110', '111', '1100011']",38,22,16,0.5789473684210527,0.4210526315789473,7,5,0.9819407868640976,0
"['101', '0011', '0110', '0110', '10', '001000', '001110', '1000000']",36,14,22,0.3888888888888889,0.6111111111111112,4,8,0.964078764808229,0
"['11001', '0', '1']",7,4,3,0.5714285714285714,0.4285714285714285,1,1,0.9852281360342516,0
"['010', '01011', '100000', '101000', '1101010', '00', '0011', '000', '1001001', '0010111']",50,20,30,0.4,0.6,4,10,0.9709505944546686,0
"['00011', '0011111', '11', '01', '1', '1', '000110']",24,14,10,0.5833333333333334,0.4166666666666667,6,3,0.9798687566511528,0
"['1101', '110101', '00001', '000010', '00', '0111', '10101']",32,15,17,0.46875,0.53125,4,6,0.9971803988942642,0
"['10100', '0', '01000', '1']",12,4,8,0.3333333333333333,0.6666666666666666,0,3,0.9182958340544896,0
"['1111', '010000', '10', '00', '1111111', '00', '0100', '0100', '000']",34,15,19,0.4411764705882353,0.5588235294117647,5,7,0.9899927915575186,0
"['00000', '000', '00011', '0']",14,2,12,0.1428571428571428,0.8571428571428571,1,5,0.5916727785823275,0
"['0', '01', '11']",5,3,2,0.6,0.4,1,1,0.9709505944546686,1
"['10', '01000', '1', '111011', '10100', '0110011', '011101', '0111', '1001010', '100']",46,25,21,0.5434782608695652,0.4565217391304347,8,6,0.994538681650011,0
"['1011110', '01001', '0100', '0111100', '10010', '110']",31,16,15,0.5161290322580645,0.4838709677419355,5,5,0.9992492479956564,1
"['1', '0111001', '00001', '11110', '10', '111', '0', '1000111']",31,18,13,0.5806451612903226,0.4193548387096774,5,4,0.9811522341999132,0
"['1001', '10', '0111', '0011000', '0110', '1001', '1011100']",32,16,16,0.5,0.5,6,7,1.0,0
"['1011100', '1', '100110', '10100', '1', '10', '011001', '1', '1']",30,17,13,0.5666666666666667,0.4333333333333333,6,5,0.9871377743721864,0
"['1100', '11101', '111', '111100', '1011011', '1001', '00', '001']",34,21,13,0.6176470588235294,0.3823529411764705,8,5,0.9596868937742168,0
['1100'],4,2,2,0.5,0.5,1,1,1.0,1
"['1110100', '1010111', '00001', '0', '0', '10011', '0110']",30,15,15,0.5,0.5,4,5,1.0,0
['1101'],4,3,1,0.75,0.25,1,0,0.8112781244591328,1
"['010', '111101', '010', '00011', '0', '1100', '110', '1100', '11', '0111']",35,20,15,0.5714285714285714,0.4285714285714285,8,4,0.9852281360342516,0
['101000'],6,2,4,0.3333333333333333,0.6666666666666666,0,1,0.9182958340544896,1
"['1100', '011100']",10,5,5,0.5,0.5,2,2,1.0,1
"['1100011', '000', '0110110', '1', '0000111', '1', '0', '001']",30,14,16,0.4666666666666667,0.5333333333333333,6,6,0.9967916319816366,0
"['001110', '1011', '0000100', '11', '011001', '011100', '1110100', '100101', '00', '01011']",51,25,26,0.4901960784313725,0.5098039215686274,7,9,0.9997226475394072,0
"['1100111', '1', '1010', '01110', '01', '1100', '00111', '1010']",32,19,13,0.59375,0.40625,7,5,0.9744894033980523,0
"['1110', '110', '1000001']",14,7,7,0.5,0.5,2,2,1.0,1
"['110111', '1011010']",13,9,4,0.6923076923076923,0.3076923076923077,4,0,0.8904916402194913,1
"['100111', '0101111', '0011', '110', '0001110', '10', '0']",30,17,13,0.5666666666666667,0.4333333333333333,6,5,0.9871377743721864,0
"['011111', '101010', '000100', '0', '0', '00', '1', '1010', '01', '1001']",33,15,18,0.4545454545454545,0.5454545454545454,5,7,0.9940302114769564,0
['101011'],6,4,2,0.6666666666666666,0.3333333333333333,1,0,0.9182958340544896,1
"['0110101', '10100', '1100', '1011100', '1010100', '10', '100010', '1001', '111001', '1']",49,25,24,0.5102040816326531,0.4897959183673469,7,7,0.9996995428565172,0
"['1001', '10', '011011', '101001', '0100010', '10', '01']",29,14,15,0.4827586206896552,0.5172413793103449,3,5,0.9991421039919088,0
"['11', '1100110', '01', '100', '0', '11', '10']",19,11,8,0.5789473684210527,0.4210526315789473,5,3,0.9819407868640976,0
"['11', '110', '0']",6,4,2,0.6666666666666666,0.3333333333333333,2,1,0.9182958340544896,0
"['1110', '01001', '10', '0101', '101', '0010', '101', '110001']",31,16,15,0.5161290322580645,0.4838709677419355,4,5,0.9992492479956564,0
"['1101', '0000']",8,3,5,0.375,0.625,1,2,0.954434002924965,1
"['0010100', '1000', '1011000', '010011']",24,9,15,0.375,0.625,2,6,0.954434002924965,1
['0'],1,0,1,0.0,1.0,0,0,-0.0,1
"['01110', '001', '011']",11,6,5,0.5454545454545454,0.4545454545454545,2,1,0.9940302114769564,1
"['0', '010', '1110010', '1010110', '11', '0100000']",27,12,15,0.4444444444444444,0.5555555555555556,3,4,0.9910760598382222,0
"['0', '1110', '1', '0011110', '11101', '000111', '0101', '011', '1', '010']",35,21,14,0.6,0.4,6,2,0.9709505944546686,0
"['0100', '101', '010']",10,4,6,0.4,0.6,0,1,0.9709505944546686,1
"['0101001', '1', '1', '111', '110']",15,10,5,0.6666666666666666,0.3333333333333333,4,1,0.9182958340544896,0
"['001', '110', '00100', '101011', '0000', '001', '10', '110110']",32,14,18,0.4375,0.5625,5,6,0.9886994082884974,0
"['0110011', '0011100', '011', '1010', '00101']",26,13,13,0.5,0.5,4,4,1.0,1
['000'],3,0,3,0.0,1.0,0,1,-0.0,1
"['0011110', '0010000', '00', '0011', '01000', '10001']",30,10,20,0.3333333333333333,0.6666666666666666,3,8,0.9182958340544896,1
"['011010', '10001', '1', '1000001', '00011', '1100111']",31,15,16,0.4838709677419355,0.5161290322580645,5,5,0.9992492479956564,0
"['11010', '1100001']",12,6,6,0.5,0.5,2,2,1.0,1
"['01110', '00001', '00111', '100110', '0101', '10', '0011100', '01']",36,17,19,0.4722222222222222,0.5277777777777778,6,7,0.997772472089982,0
"['0100', '0100', '110', '0110011']",18,8,10,0.4444444444444444,0.5555555555555556,3,4,0.9910760598382222,1
['000'],3,0,3,0.0,1.0,0,1,-0.0,1
"['0100', '0110', '11', '1001', '01', '11100']",21,11,10,0.5238095238095238,0.4761904761904761,4,3,0.998363672593813,0
"['11', '11', '01101', '010110', '1100', '101', '00']",24,14,10,0.5833333333333334,0.4166666666666667,5,2,0.9798687566511528,0
"['010', '0', '11011', '111000', '01', '1011110', '00', '10101']",31,17,14,0.5483870967741935,0.4516129032258064,6,4,0.9932338197397066,0
"['0011', '0101111', '101', '0001011', '01010', '110', '10110', '10']",36,20,16,0.5555555555555556,0.4444444444444444,6,2,0.9910760598382222,0
"['0000', '111', '10110', '1110', '11001', '100', '101100', '000011', '11', '1']",39,21,18,0.5384615384615384,0.4615384615384615,9,7,0.9957274520849256,0
"['00', '0101011', '00', '10', '10100', '1101001']",25,11,14,0.44,0.56,2,4,0.9895875212220556,1
"['01', '101', '00011', '11', '01']",14,8,6,0.5714285714285714,0.4285714285714285,3,1,0.9852281360342516,1
"['110', '111', '0011100', '0010', '0101', '00110', '1']",27,14,13,0.5185185185185185,0.4814814814814814,4,5,0.9990102708804812,0
"['10001', '0111', '0110', '0', '1000', '010']",21,9,12,0.4285714285714285,0.5714285714285714,2,4,0.9852281360342516,0
"['0000011', '010010', '10', '011', '00110', '11', '00', '1110']",31,14,17,0.4516129032258064,0.5483870967741935,5,6,0.9932338197397066,0
"['1000111', '1111', '0101000', '111', '0111', '010100', '0111100', '00', '001100']",46,24,22,0.5217391304347826,0.4782608695652174,8,7,0.9986359641585718,0
"['100', '0110011', '000', '11']",15,7,8,0.4666666666666667,0.5333333333333333,3,3,0.9967916319816366,1
"['0', '0111100', '100000', '111001', '11111']",25,14,11,0.56,0.44,6,5,0.9895875212220556,1
"['01111', '0101', '01010', '001100', '001', '1']",24,12,12,0.5,0.5,4,3,1.0,0
"['111111', '11']",8,8,0,1.0,0.0,4,0,-0.0,0
"['111001', '010', '11', '1', '011']",15,10,5,0.6666666666666666,0.3333333333333333,3,1,0.9182958340544896,0
"['0', '01010', '110', '1011111', '01', '00101', '0001101']",30,16,14,0.5333333333333333,0.4666666666666667,4,3,0.9967916319816366,0
"['011100', '1111', '101', '01010']",18,11,7,0.6111111111111112,0.3888888888888889,3,1,0.964078764808229,1
"['0000', '1', '1011100', '1100011', '1000', '1', '100', '0001000', '11']",36,15,21,0.4166666666666667,0.5833333333333334,6,8,0.9798687566511528,0
"['010110', '1110101', '1', '101', '0', '0', '111']",22,14,8,0.6363636363636364,0.3636363636363636,4,1,0.94566030460064,0
"['101111', '11111']",11,10,1,0.9090909090909092,0.0909090909090909,4,0,0.4394969869215134,1
"['101100', '00', '1', '1', '0001100', '11010']",22,10,12,0.4545454545454545,0.5454545454545454,4,4,0.9940302114769564,1
"['11', '110100', '1000', '0000', '1100', '10', '10', '0100', '1100100']",35,14,21,0.4,0.6,4,9,0.9709505944546686,0
"['0001111', '000', '101', '0']",14,6,8,0.4285714285714285,0.5714285714285714,2,2,0.9852281360342516,0
['0'],1,0,1,0.0,1.0,0,0,-0.0,1
"['1', '1101', '01', '101111', '0000', '110101', '010']",26,15,11,0.5769230769230769,0.4230769230769231,5,2,0.9828586897127056,0
"['000001', '00', '1010011', '10010', '0110001', '0011', '00', '1001010', '001000', '010']",49,17,32,0.3469387755102041,0.6530612244897959,3,13,0.9313043685793764,0
"['010010', '000010', '000100', '1101', '1011', '001']",29,11,18,0.3793103448275862,0.6206896551724138,3,7,0.9575534837147482,1
"['00111', '00', '00', '101001', '0101100', '0000010', '001101', '0001000', '10101', '10']",49,18,31,0.3673469387755102,0.6326530612244898,4,10,0.9486131982385806,0
"['1100100', '110000', '0011', '1111']",21,11,10,0.5238095238095238,0.4761904761904761,5,5,0.998363672593813,1
"['111', '101']",6,5,1,0.8333333333333334,0.1666666666666666,2,0,0.6500224216483541,1
"['0011', '0']",5,2,3,0.4,0.6,1,1,0.9709505944546686,1
"['01', '1111', '10000', '101110', '01000', '011', '0110110']",32,17,15,0.53125,0.46875,7,5,0.9971803988942642,1
"['10', '0', '1101000']",10,4,6,0.4,0.6,1,2,0.9709505944546686,1
"['00011', '100', '110101']",14,7,7,0.5,0.5,2,2,1.0,1
['01'],2,1,1,0.5,0.5,0,0,1.0,1
"['100', '100100', '11', '1']",12,6,6,0.5,0.5,1,3,1.0,0
"['0111', '100', '11', '11', '1111110', '100100', '1011', '001101', '011000']",40,24,16,0.6,0.4,10,5,0.9709505944546686,0
"['100', '000011', '001']",12,4,8,0.3333333333333333,0.6666666666666666,1,4,0.9182958340544896,1
"['00110', '011011']",11,6,5,0.5454545454545454,0.4545454545454545,3,2,0.9940302114769564,1
"['0010', '10011', '0110', '0']",14,6,8,0.4285714285714285,0.5714285714285714,2,3,0.9852281360342516,0
"['01011', '00110', '1110', '001', '010000', '1100', '01101', '111', '0011100', '000010']",48,22,26,0.4583333333333333,0.5416666666666666,8,9,0.99498482818597,0
"['000', '0', '11', '110', '000101', '110001', '0101']",25,11,14,0.44,0.56,3,5,0.9895875212220556,0
"['00011', '111', '111010', '00', '0111', '0', '111101', '0', '01', '0100111']",37,22,15,0.5945945945945946,0.4054054054054054,8,5,0.974024864435752,0
"['10', '01101', '011', '1000', '000111', '11', '10', '111', '1101100']",34,20,14,0.5882352941176471,0.4117647058823529,8,5,0.9774178175281716,0
"['00', '1', '00', '00', '100100']",13,3,10,0.2307692307692307,0.7692307692307693,0,5,0.7793498372920851,0
"['000011', '1100', '1', '0', '001']",15,6,9,0.4,0.6,2,4,0.9709505944546686,0
"['010000', '00010', '1110', '1100110', '1111', '0110', '1']",31,16,15,0.5161290322580645,0.4838709677419355,6,4,0.9992492479956564,0
['011'],3,2,1,0.6666666666666666,0.3333333333333333,1,0,0.9182958340544896,1
"['101111', '11110', '1010']",15,11,4,0.7333333333333333,0.2666666666666666,4,0,0.8366407419411672,1
"['10', '1101', '1100', '101', '1001', '1100110', '11', '01010', '1100001']",38,21,17,0.5526315789473685,0.4473684210526316,7,5,0.9919924034538556,0
['01'],2,1,1,0.5,0.5,0,0,1.0,1
"['0', '111100', '010011', '11111', '01010', '1011000', '01', '11110', '101', '101101']",46,28,18,0.6086956521739131,0.391304347826087,10,4,0.9656361333706098,0
"['11001', '0']",6,3,3,0.5,0.5,1,1,1.0,1
"['0', '11', '10111', '011101', '010110', '1', '000', '101']",27,16,11,0.5925925925925926,0.4074074074074074,4,1,0.975119064940866,0
"['000', '1011001', '0011', '010011', '101110', '1', '110110', '110', '110', '1']",40,23,17,0.575,0.425,8,4,0.983708262623186,0
"['1010', '101000', '1', '1100']",15,7,8,0.4666666666666667,0.5333333333333333,1,2,0.9967916319816366,1
"['111110', '100', '010']",12,7,5,0.5833333333333334,0.4166666666666667,2,1,0.9798687566511528,1
"['11', '11']",4,4,0,1.0,0.0,2,0,-0.0,1
"['110111', '1', '11', '000010', '101010', '0', '1', '00101', '01101', '0001011']",40,21,19,0.525,0.475,6,5,0.99819587904281,0
"['01', '110111', '1110', '000', '00001', '10110', '01', '01101', '0000']",36,17,19,0.4722222222222222,0.5277777777777778,7,7,0.997772472089982,0
"['0', '00001', '10001', '11001', '00010', '0', '1010', '11101']",31,13,18,0.4193548387096774,0.5806451612903226,3,6,0.9811522341999132,0
"['01000', '111110']",11,6,5,0.5454545454545454,0.4545454545454545,2,1,0.9940302114769564,1
['1100'],4,2,2,0.5,0.5,1,1,1.0,1
"['11', '10001', '10101', '0010001']",19,9,10,0.4736842105263157,0.5263157894736842,2,3,0.9980008838722996,1
"['00110', '00010', '11', '11100']",17,8,9,0.4705882352941176,0.5294117647058824,3,4,0.9975025463691152,1
"['00', '00', '11', '00010']",11,3,8,0.2727272727272727,0.7272727272727273,1,3,0.8453509366224364,1
"['000111', '101010']",12,6,6,0.5,0.5,2,1,1.0,1
"['0110100', '011100', '0000', '0111', '0', '1101111']",29,15,14,0.5172413793103449,0.4827586206896552,6,4,0.9991421039919088,0
"['1110100', '000000', '0', '100', '0', '1', '000110', '100000', '1001', '100000']",41,12,29,0.2926829268292683,0.7073170731707317,3,11,0.8721617883411701,0
"['011', '0011111', '00101', '00', '11101', '0101', '1', '11011', '01']",34,21,13,0.6176470588235294,0.3823529411764705,7,3,0.9596868937742168,0
"['1010', '1', '011', '1101000', '11', '1']",18,11,7,0.6111111111111112,0.3888888888888889,3,1,0.964078764808229,0
"['01', '0', '111001', '0', '110', '0101', '000100']",23,10,13,0.4347826086956521,0.5652173913043478,2,4,0.9876925088958034,0
"['011000', '00', '0001', '01011', '1110010', '0', '010000', '00', '010', '100110']",42,15,27,0.3571428571428571,0.6428571428571429,4,10,0.9402859586706313,0
"['1001', '100', '0010', '101', '1', '0']",16,7,9,0.4375,0.5625,2,3,0.9886994082884974,0
"['001', '11', '010', '110010', '1010', '0101', '01', '10', '001']",29,14,15,0.4827586206896552,0.5172413793103449,3,4,0.9991421039919088,0
"['0110', '0', '1110', '1111', '1100110', '11', '111', '0']",26,18,8,0.6923076923076923,0.3076923076923077,8,2,0.8904916402194913,0
"['010111', '101']",9,6,3,0.6666666666666666,0.3333333333333333,2,0,0.9182958340544896,1
"['10011', '01', '0', '1001', '11111', '10110', '0']",23,14,9,0.6086956521739131,0.391304347826087,5,3,0.9656361333706098,0
['01111'],5,4,1,0.8,0.2,2,0,0.7219280948873623,1
"['000', '100', '110001', '010101', '01', '001', '01', '0']",26,10,16,0.3846153846153846,0.6153846153846154,1,4,0.961236604722876,0
"['000011', '0110111', '101000', '100', '001', '011111', '00000']",36,16,20,0.4444444444444444,0.5555555555555556,6,7,0.9910760598382222,1
"['011001', '0010', '0110000']",17,6,11,0.3529411764705882,0.6470588235294118,2,5,0.9366673818775626,1
"['1', '111', '1111011', '00', '110010', '000111', '0', '01', '111001']",34,21,13,0.6176470588235294,0.3823529411764705,9,6,0.9596868937742168,0
"['110', '01']",5,3,2,0.6,0.4,1,1,0.9709505944546686,1
"['010', '1000']",7,2,5,0.2857142857142857,0.7142857142857143,0,1,0.863120568566631,1
"['0', '1010101', '011001', '101', '01011', '010', '11101']",30,17,13,0.5666666666666667,0.4333333333333333,4,1,0.9871377743721864,0
"['00', '11', '101011', '0001110', '1001110', '1001000', '11000', '1100110']",43,21,22,0.4883720930232558,0.5116279069767442,7,7,0.999609836367807,0
"['1001100', '11011', '101100', '1100', '0', '001', '100']",29,14,15,0.4827586206896552,0.5172413793103449,6,6,0.9991421039919088,0
"['101011', '0011', '100', '1101', '010110', '001010', '101', '011', '0101']",39,21,18,0.5384615384615384,0.4615384615384615,5,3,0.9957274520849256,0
"['1', '1', '111', '11', '00110', '1000110']",19,12,7,0.631578947368421,0.3684210526315789,5,2,0.9494520153879484,0
['11'],2,2,0,1.0,0.0,1,0,-0.0,1
"['101', '11100', '101001']",14,8,6,0.5714285714285714,0.4285714285714285,2,2,0.9852281360342516,1
"['1101', '111101', '10', '0', '1001']",17,11,6,0.6470588235294118,0.3529411764705882,4,2,0.9366673818775626,0
"['111110', '1101', '11000', '1010010']",22,13,9,0.5909090909090909,0.4090909090909091,4,2,0.9760206482366148,1
"['01001', '1111101', '10010', '111100', '010010', '0101']",33,18,15,0.5454545454545454,0.4545454545454545,6,5,0.9940302114769564,0
"['0', '1', '0101', '1000000', '00', '110000', '01110', '11', '1101', '010001']",38,16,22,0.4210526315789473,0.5789473684210527,5,7,0.9819407868640976,0
"['1110011', '100', '011', '001', '011', '11', '110101', '100']",30,18,12,0.6,0.4,7,4,0.9709505944546686,0
"['0', '00101', '010011', '00110', '0001', '11', '001110', '101']",32,15,17,0.46875,0.53125,4,6,0.9971803988942642,0
"['1', '10', '0111010', '000', '0100', '001100', '1']",24,10,14,0.4166666666666667,0.5833333333333334,3,6,0.9798687566511528,0
"['0100', '11001', '1011011', '1', '0010001', '10111', '1010', '110', '001', '0110001']",46,24,22,0.5217391304347826,0.4782608695652174,9,6,0.9986359641585718,0
"['1010', '11110', '01000', '01', '0', '110111', '011101', '0110', '0110']",37,21,16,0.5675675675675675,0.4324324324324324,7,4,0.9867867202680318,0
"['011', '1111', '0001', '0001', '00', '0']",18,8,10,0.4444444444444444,0.5555555555555556,3,3,0.9910760598382222,0
"['0111001', '1010000', '10', '1110', '010000', '001010']",32,13,19,0.40625,0.59375,3,7,0.9744894033980523,1
"['11111', '10', '1101000']",14,9,5,0.6428571428571429,0.3571428571428571,4,1,0.9402859586706313,1
"['1', '11', '1', '110', '010101', '1110100']",20,13,7,0.65,0.35,5,2,0.934068055375491,0
"['010010', '11', '0101010', '000011', '1111000', '0011011', '1010']",39,19,20,0.4871794871794871,0.5128205128205128,6,5,0.999525689293649,1
"['01011', '0', '011', '111']",12,8,4,0.6666666666666666,0.3333333333333333,3,1,0.9182958340544896,1
"['011', '1010', '0000', '111', '00', '101', '110101']",25,13,12,0.52,0.48,3,3,0.9988455359952018,0
"['010', '1001', '0101', '0011000', '000001', '0', '000011', '1000']",35,11,24,0.3142857142857143,0.6857142857142857,2,9,0.898058793450166,0
"['010', '0', '011', '0']",8,3,5,0.375,0.625,1,1,0.954434002924965,1
"['11001', '111', '10010', '1111001', '0001']",24,14,10,0.5833333333333334,0.4166666666666667,5,4,0.9798687566511528,1
"['10110', '01000']",10,4,6,0.4,0.6,1,2,0.9709505944546686,1
"['101', '111', '11', '1111011', '00011', '1', '11']",23,18,5,0.782608695652174,0.217391304347826,8,1,0.7553754125614287,0
"['00110', '110', '0100', '0101111', '0', '1001110', '111']",30,17,13,0.5666666666666667,0.4333333333333333,6,4,0.9871377743721864,0
"['1', '000110', '01011', '0010010', '0110100', '1', '011']",30,14,16,0.4666666666666667,0.5333333333333333,4,6,0.9967916319816366,1
"['000101', '0110000', '00000', '0100', '1']",23,6,17,0.2608695652173913,0.7391304347826086,1,7,0.828055725379504,1
"['01', '1011000', '10', '1101', '011100', '000001', '0001100', '000101']",40,16,24,0.4,0.6,5,7,0.9709505944546686,1
"['1100', '00', '1000', '11', '0000001', '100111', '1110', '111', '1110']",36,19,17,0.5277777777777778,0.4722222222222222,9,7,0.997772472089982,0
"['0', '10011', '11110', '11011']",16,11,5,0.6875,0.3125,5,1,0.8960382325345574,1
"['0', '1010', '1000110']",12,5,7,0.4166666666666667,0.5833333333333334,1,1,0.9798687566511528,1
"['0101010', '1001010', '000']",17,6,11,0.3529411764705882,0.6470588235294118,0,3,0.9366673818775626,1
"['1', '001110', '0110011', '10001', '010']",22,11,11,0.5,0.5,3,4,1.0,1
"['11001', '00', '11111', '1', '1101', '0011']",21,14,7,0.6666666666666666,0.3333333333333333,6,3,0.9182958340544896,0
"['0001010', '1001', '1000100', '0101']",22,8,14,0.3636363636363636,0.6363636363636364,1,4,0.94566030460064,1
"['111111', '1', '010', '10', '101010', '0110001', '1111', '101001']",35,22,13,0.6285714285714286,0.3714285714285714,7,3,0.9517626756348312,0
"['1', '0001', '0010', '110']",12,5,7,0.4166666666666667,0.5833333333333334,1,2,0.9798687566511528,1
"['01', '0000']",6,1,5,0.1666666666666666,0.8333333333333334,0,2,0.6500224216483541,1
"['0', '0', '1101', '1000010', '011', '0', '011', '011101']",26,13,13,0.5,0.5,5,5,1.0,0
"['0111', '01000', '1100101', '1100']",20,10,10,0.5,0.5,3,3,1.0,1
"['1110', '1110101', '1101001', '0101', '00111', '101001', '100', '01100']",41,23,18,0.5609756097560976,0.4390243902439024,7,5,0.9892452969285004,0
['111'],3,3,0,1.0,0.0,1,0,-0.0,1
"['100', '1110', '011100']",13,7,6,0.5384615384615384,0.4615384615384615,2,3,0.9957274520849256,1
"['000100', '11', '0011', '01', '1', '1100', '010', '10111', '111']",30,17,13,0.5666666666666667,0.4333333333333333,7,4,0.9871377743721864,0
"['11', '1', '011', '00']",8,5,3,0.625,0.375,2,1,0.954434002924965,0
"['0010000', '11', '0001', '10', '00', '01', '100010', '1', '100010', '101']",35,13,22,0.3714285714285714,0.6285714285714286,4,8,0.9517626756348312,0
"['100010', '011', '111', '011011', '11', '1101', '0110011']",31,20,11,0.6451612903225806,0.3548387096774194,8,3,0.9383153522334068,0
"['010', '0', '0010110', '1', '1']",13,6,7,0.4615384615384615,0.5384615384615384,2,2,0.9957274520849256,0
['110001'],6,3,3,0.5,0.5,1,1,1.0,1
"['110', '0101010', '0']",11,5,6,0.4545454545454545,0.5454545454545454,1,2,0.9940302114769564,1
"['11', '0011101', '0', '000', '101', '1', '00']",19,9,10,0.4736842105263157,0.5263157894736842,3,4,0.9980008838722996,0
"['11', '11']",4,4,0,1.0,0.0,2,0,-0.0,1
"['100000', '1', '000100', '1001101', '01', '0011', '1', '1111', '1000101', '001101']",44,21,23,0.4772727272727273,0.5227272727272727,6,8,0.9985090989176322,0
"['10', '00000', '00']",9,1,8,0.1111111111111111,0.8888888888888888,0,4,0.5032583347756457,0
"['1101', '01111', '01110', '0111101', '110', '1001101', '001', '11110', '001000']",45,27,18,0.6,0.4,10,5,0.9709505944546686,0
"['0101', '01', '111', '00000']",14,6,8,0.4285714285714285,0.5714285714285714,2,2,0.9852281360342516,0
"['0110001', '11110', '000100', '0', '000001', '1']",26,10,16,0.3846153846153846,0.6153846153846154,4,7,0.961236604722876,0
"['100', '0000011', '0', '0', '1110', '00']",18,6,12,0.3333333333333333,0.6666666666666666,2,5,0.9182958340544896,0
"['11101', '001111']",11,8,3,0.7272727272727273,0.2727272727272727,3,1,0.8453509366224364,1
"['01101', '100000', '101', '1011101', '010', '0111011', '11', '1']",34,20,14,0.5882352941176471,0.4117647058823529,7,3,0.9774178175281716,0
"['0', '1011', '10', '1111100', '0', '11', '100011', '1100', '11010', '110000']",38,21,17,0.5526315789473685,0.4473684210526316,8,5,0.9919924034538556,0
"['11101', '001000']",11,5,6,0.4545454545454545,0.5454545454545454,1,2,0.9940302114769564,1
"['10', '000', '00', '100', '101000']",16,4,12,0.25,0.75,0,5,0.8112781244591328,0
"['1000', '0', '0011']",9,3,6,0.3333333333333333,0.6666666666666666,1,3,0.9182958340544896,1
"['1', '100', '011', '110111', '11011', '0', '1101101', '0', '111']",30,21,9,0.7,0.3,9,1,0.8812908992306927,0
"['101010', '000111', '1101010', '0010100', '0010', '0', '100']",34,14,20,0.4117647058823529,0.5882352941176471,2,7,0.9774178175281716,0
"['1010010', '0', '1011110', '011101', '00111', '0100100', '001', '11', '110111', '00110']",49,27,22,0.5510204081632653,0.4489795918367347,8,8,0.992476003943082,0
"['1', '0']",2,1,1,0.5,0.5,0,0,1.0,1
"['0010', '000101', '00110', '101101', '1001', '101001', '0']",32,14,18,0.4375,0.5625,4,6,0.9886994082884974,0
"['10101', '0', '011110', '1111', '1001', '1101', '11100', '010']",32,20,12,0.625,0.375,7,3,0.954434002924965,0
"['1000', '11010', '0100', '01']",15,6,9,0.4,0.6,1,3,0.9709505944546686,1
"['1111', '0111', '11111', '1', '0111111', '1001', '01']",27,22,5,0.8148148148148148,0.1851851851851851,9,1,0.691289869405789,0
"['10101', '00000', '101100', '00110', '110001', '1', '100']",31,13,18,0.4193548387096774,0.5806451612903226,4,6,0.9811522341999132,0
"['01010', '11', '11', '0010', '0011', '1111101', '0', '1111', '10110', '111011']",40,27,13,0.675,0.325,10,2,0.9097361225311662,0
"['010', '1001110', '00', '1101100', '1101100', '1001', '101011', '1', '10', '11']",41,23,18,0.5609756097560976,0.4390243902439024,9,5,0.9892452969285004,0
"['11', '100100', '010', '0', '110101', '0']",19,9,10,0.4736842105263157,0.5263157894736842,2,3,0.9980008838722996,0
"['0100100', '0011011', '01001', '110101', '11', '10', '1000', '1110']",37,19,18,0.5135135135135135,0.4864864864864865,6,5,0.9994730201859836,0
['00101'],5,2,3,0.4,0.6,0,1,0.9709505944546686,1
"['0110', '1', '0100010', '0101011', '110101', '10110', '110010', '1111', '10011', '1']",46,27,19,0.5869565217391305,0.4130434782608695,9,4,0.978070970973496,0
"['010', '11', '0', '000100', '0101', '0000101', '110']",26,10,16,0.3846153846153846,0.6153846153846154,2,5,0.961236604722876,0
"['1011100', '101', '011', '011', '01101', '010100']",27,15,12,0.5555555555555556,0.4444444444444444,4,2,0.9910760598382222,0
"['101', '1', '01101', '00100', '111']",17,10,7,0.5882352941176471,0.4117647058823529,3,2,0.9774178175281716,0
"['1', '1101101', '01110', '0000', '0', '0111', '010']",25,13,12,0.52,0.48,4,3,0.9988455359952018,0
['11'],2,2,0,1.0,0.0,1,0,-0.0,1
"['0', '001', '101100', '11', '0010010']",19,8,11,0.4210526315789473,0.5789473684210527,3,4,0.9819407868640976,0
"['0', '00100', '11', '0', '0110', '110', '0', '01', '00101']",24,10,14,0.4166666666666667,0.5833333333333334,3,5,0.9798687566511528,0
"['101', '10', '00110', '01111', '1', '001', '100100', '0101001', '10']",34,17,17,0.5,0.5,6,6,1.0,0
"['110', '101', '0000001', '1', '10100', '00000', '10110', '00000', '01']",36,12,24,0.3333333333333333,0.6666666666666666,3,9,0.9182958340544896,0
"['00', '0', '10011', '001', '11111', '1000', '11']",22,12,10,0.5454545454545454,0.4545454545454545,5,4,0.9940302114769564,0
['0111000'],7,3,4,0.4285714285714285,0.5714285714285714,1,1,0.9852281360342516,1
"['11', '0000110', '0000', '1001', '1011001', '1', '111', '01', '11011', '1']",36,20,16,0.5555555555555556,0.4444444444444444,8,6,0.9910760598382222,0
"['0100101', '0000000', '110001', '00101', '0', '00', '01110', '0101', '0']",38,13,25,0.3421052631578947,0.6578947368421053,2,9,0.9268190639645772,0
"['01100', '0', '11101', '000', '00']",16,6,10,0.375,0.625,2,3,0.954434002924965,0
"['10', '010', '0101101']",12,6,6,0.5,0.5,1,2,1.0,1
"['00', '100', '110100']",11,4,7,0.3636363636363636,0.6363636363636364,1,3,0.94566030460064,1
"['010010', '0110', '0101110', '00001', '11000']",27,11,16,0.4074074074074074,0.5925925925925926,3,6,0.975119064940866,1
"['001100', '1', '10', '110001', '1']",16,8,8,0.5,0.5,4,3,1.0,1
['011'],3,2,1,0.6666666666666666,0.3333333333333333,1,0,0.9182958340544896,1
"['101000', '0101101']",13,6,7,0.4615384615384615,0.5384615384615384,1,2,0.9957274520849256,1
['001'],3,1,2,0.3333333333333333,0.6666666666666666,0,1,0.9182958340544896,1
"['0', '01101', '10010', '100110', '0001', '001', '100111']",30,14,16,0.4666666666666667,0.5333333333333333,5,7,0.9967916319816366,0
"['0101', '01111', '01000', '0100', '111', '010', '1100']",28,14,14,0.5,0.5,4,4,1.0,1
"['0110111', '0', '100', '01']",13,7,6,0.5384615384615384,0.4615384615384615,2,1,0.9957274520849256,0
"['0110', '111', '10', '01011', '100110']",20,12,8,0.6,0.4,5,2,0.9709505944546686,0
"['010111', '00', '01', '1', '00101']",16,8,8,0.5,0.5,2,2,1.0,0
"['0111101', '101100', '001', '100001', '011', '0111100', '0001', '1101']",40,21,19,0.525,0.475,9,6,0.99819587904281,0
"['111', '111', '00', '1']",9,7,2,0.7777777777777778,0.2222222222222222,3,1,0.7642045065086203,0
"['00011', '00']",7,2,5,0.2857142857142857,0.7142857142857143,1,2,0.863120568566631,1
"['0110000', '110111', '10', '11', '1000010', '11', '0', '111010', '1011010']",40,22,18,0.55,0.45,8,4,0.9927744539878084,0
"['010', '10', '0011', '0111', '01']",15,8,7,0.5333333333333333,0.4666666666666667,2,1,0.9967916319816366,0
"['1001101', '10', '1110000', '100', '0']",20,9,11,0.45,0.55,3,4,0.9927744539878084,0
"['1', '0001111', '0', '1010', '0100', '1101', '111', '1011110', '1000010', '111']",41,24,17,0.5853658536585366,0.4146341463414634,8,5,0.9788698505067784,0
"['1000011', '1010']",11,5,6,0.4545454545454545,0.5454545454545454,1,2,0.9940302114769564,1
"['1', '010001', '0001010', '111001', '0000', '0000110', '01', '10', '10']",37,14,23,0.3783783783783784,0.6216216216216216,3,8,0.9568886656798212,0
"['0', '111111']",7,6,1,0.8571428571428571,0.1428571428571428,3,0,0.5916727785823275,1
"['100', '10', '001111', '010100', '1', '110110', '10110']",29,16,13,0.5517241379310345,0.4482758620689655,5,3,0.9922666387194964,0
"['10111', '1', '001']",9,6,3,0.6666666666666666,0.3333333333333333,2,1,0.9182958340544896,1
"['111', '11', '1011110', '1', '110110', '01', '111']",24,19,5,0.7916666666666666,0.2083333333333333,9,1,0.7382848661434506,0
"['11010', '11', '010010', '0100111', '01', '1001011', '10', '1111']",35,21,14,0.6,0.4,7,4,0.9709505944546686,0
['1'],1,1,0,1.0,0.0,0,0,-0.0,1
"['10', '110', '00110', '0', '0', '0000100', '1', '11']",22,9,13,0.4090909090909091,0.5909090909090909,3,5,0.9760206482366148,0
"['1010000', '01', '110111', '100', '0111111', '1']",26,16,10,0.6153846153846154,0.3846153846153846,6,3,0.961236604722876,0
"['0', '110011', '011010', '0']",14,7,7,0.5,0.5,3,2,1.0,1
"['0', '111', '010101', '1', '11', '1111']",17,13,4,0.7647058823529411,0.2352941176470588,5,0,0.7871265862012691,0
"['1011', '0', '11011', '0', '11100', '0000', '0100111']",27,14,13,0.5185185185185185,0.4814814814814814,5,4,0.9990102708804812,0
"['0000', '0111', '01', '0001000', '101', '00100', '100']",28,9,19,0.3214285714285714,0.6785714285714286,1,7,0.9059282160429992,1
"['011', '1110001', '1']",11,7,4,0.6363636363636364,0.3636363636363636,3,1,0.94566030460064,1
"['011', '001', '00', '1111111']",15,10,5,0.6666666666666666,0.3333333333333333,4,2,0.9182958340544896,1
"['0011011', '0']",8,4,4,0.5,0.5,2,1,1.0,1
"['010100', '00110', '1111101', '10']",20,11,9,0.55,0.45,4,2,0.9927744539878084,1
"['10', '0111', '010010', '1111011', '01011', '10111', '0', '0011000', '00']",39,21,18,0.5384615384615384,0.4615384615384615,7,5,0.9957274520849256,0
"['01', '1101011', '1110010', '0', '111']",20,13,7,0.65,0.35,4,2,0.934068055375491,0
"['11', '1100000', '100']",12,5,7,0.4166666666666667,0.5833333333333334,2,3,0.9798687566511528,1
"['101', '00010', '0101111', '0011', '010', '00001', '0110']",31,14,17,0.4516129032258064,0.5483870967741935,4,5,0.9932338197397066,1
"['110', '000111', '1101100', '11', '1', '110', '10', '11011', '01100']",34,21,13,0.6176470588235294,0.3823529411764705,9,4,0.9596868937742168,0
"['10', '10', '0000000', '00', '100100', '0000', '1000101', '1000001', '111011', '00010']",48,15,33,0.3125,0.6875,4,13,0.8960382325345574,0
"['100', '010011', '00', '0111', '0010100', '0110', '1001', '0000001', '0111110', '101']",47,21,26,0.4468085106382978,0.5531914893617021,5,9,0.9918207974218424,0
['10'],2,1,1,0.5,0.5,0,0,1.0,1
"['1', '0111110', '1']",9,7,2,0.7777777777777778,0.2222222222222222,2,0,0.7642045065086203,1
"['1000111', '11010']",12,7,5,0.5833333333333334,0.4166666666666667,2,1,0.9798687566511528,1
"['110011', '01', '110', '11', '0001', '010001', '0011', '001000', '100011', '10']",41,19,22,0.4634146341463415,0.5365853658536586,6,7,0.9961344835095796,0
"['11', '010', '110001', '001', '0110', '11', '0101111']",27,16,11,0.5925925925925926,0.4074074074074074,6,2,0.975119064940866,0
"['00010', '01011', '100000', '100', '1010', '1', '1', '0000000', '1', '011010']",39,14,25,0.358974358974359,0.6410256410256411,3,8,0.9418285354475155,0
"['1', '1', '110', '01100', '00']",12,6,6,0.5,0.5,3,3,1.0,0
"['000', '001', '1010011', '101100', '011', '11101', '1000010', '10000', '01010']",44,19,25,0.4318181818181818,0.5681818181818182,6,8,0.9865446300055644,0
"['0', '1111011', '1', '000101', '100011', '001', '00']",26,13,13,0.5,0.5,5,4,1.0,0
"['1', '00011', '111', '1', '00000', '111', '10010', '000']",26,12,14,0.4615384615384615,0.5384615384615384,5,6,0.9957274520849256,0
"['1011100', '0110011', '1', '110', '1001011', '1010', '00011']",34,19,15,0.5588235294117647,0.4411764705882353,6,5,0.9899927915575186,1
"['110011', '1', '101', '110', '00', '01110', '1110', '0001', '01100']",33,18,15,0.5454545454545454,0.4545454545454545,7,6,0.9940302114769564,0
"['00001', '1', '01001', '1']",12,5,7,0.4166666666666667,0.5833333333333334,2,3,0.9798687566511528,1
"['1110', '1', '1011111', '10111', '110111', '0100011']",30,22,8,0.7333333333333333,0.2666666666666666,9,1,0.8366407419411672,0
"['111', '00', '111010', '10001', '01110', '0100010', '010110', '0010000']",41,18,23,0.4390243902439024,0.5609756097560976,4,8,0.9892452969285004,0
"['100000', '0100000', '000001', '0110011', '01', '1011', '01101']",37,14,23,0.3783783783783784,0.6216216216216216,5,9,0.9568886656798212,0
"['100', '11', '0001', '00', '1111']",15,8,7,0.5333333333333333,0.4666666666666667,3,3,0.9967916319816366,0
"['100111', '1011', '01', '11111', '011110', '000', '0', '10000']",32,18,14,0.5625,0.4375,8,5,0.9886994082884974,0
"['1001000', '0010000', '0']",15,3,12,0.2,0.8,0,5,0.7219280948873623,1
"['1001', '11', '10110', '0', '0011111', '001000', '1110']",29,16,13,0.5517241379310345,0.4482758620689655,6,5,0.9922666387194964,0
"['01', '110000', '10', '11100', '101111', '01100', '1001', '0011', '1001']",38,20,18,0.5263157894736842,0.4736842105263157,6,7,0.9980008838722996,0
"['10011', '0', '1101100', '0', '11', '10111', '0']",22,13,9,0.5909090909090909,0.4090909090909091,5,2,0.9760206482366148,0
"['110001', '0111', '00', '0', '110010', '0101010', '000', '001', '001', '1000']",39,15,24,0.3846153846153846,0.6153846153846154,4,9,0.961236604722876,0
"['0', '11', '0', '1', '00', '100010', '10', '11']",17,8,9,0.4705882352941176,0.5294117647058824,2,2,0.9975025463691152,0
"['0000011', '10010', '0100001', '1000000', '00', '0', '1000', '001']",36,9,27,0.25,0.75,2,12,0.8112781244591328,0
['100'],3,1,2,0.3333333333333333,0.6666666666666666,0,1,0.9182958340544896,1
"['1100010', '01000']",12,4,8,0.3333333333333333,0.6666666666666666,1,3,0.9182958340544896,1
"['10100', '1111010', '00', '01111', '001']",22,12,10,0.5454545454545454,0.4545454545454545,4,4,0.9940302114769564,1
"['110101', '00111']",11,7,4,0.6363636363636364,0.3636363636363636,2,1,0.94566030460064,1
"['00110', '0', '01', '101', '0101111']",18,10,8,0.5555555555555556,0.4444444444444444,4,2,0.9910760598382222,0
"['11', '101100', '0000', '011010', '10001', '1']",24,11,13,0.4583333333333333,0.5416666666666666,4,4,0.99498482818597,0
"['0110001', '1001000', '1101', '0011']",22,10,12,0.4545454545454545,0.5454545454545454,4,4,0.9940302114769564,1
"['0011011', '001', '0', '10001', '00011', '110', '0011']",28,13,15,0.4642857142857143,0.5357142857142857,5,5,0.996316519558962,0
"['111', '1111', '011001', '1']",14,11,3,0.7857142857142857,0.2142857142857142,5,1,0.74959525725948,0
"['111100', '11001', '01', '00', '10001', '0011101', '01110', '10000', '00110']",42,20,22,0.4761904761904761,0.5238095238095238,6,8,0.998363672593813,0
"['11110', '000', '11', '00', '0101010', '0001', '1110000', '1101001']",37,17,20,0.4594594594594595,0.5405405405405406,6,8,0.9952525494396792,0
['0'],1,0,1,0.0,1.0,0,0,-0.0,1
['1110'],4,3,1,0.75,0.25,1,0,0.8112781244591328,1
"['00110', '1000', '11101']",14,7,7,0.5,0.5,2,2,1.0,1
"['010', '111', '00110']",11,6,5,0.5454545454545454,0.4545454545454545,2,1,0.9940302114769564,1
"['10', '0001', '0', '001011', '11101', '00000']",23,9,14,0.391304347826087,0.6086956521739131,2,5,0.9656361333706098,0
"['0001', '00', '1011001', '101111', '110111', '0', '0101011', '11111', '0010']",42,25,17,0.5952380952380952,0.4047619047619047,9,5,0.97366806454962,0
"['00', '00111', '1101', '111011', '010', '01101', '1', '00', '1110', '10']",34,20,14,0.5882352941176471,0.4117647058823529,8,4,0.9774178175281716,0
"['01', '0011100', '1001']",13,6,7,0.4615384615384615,0.5384615384615384,1,3,0.9957274520849256,1
"['1', '0', '0001011', '100011', '01000', '0000101', '0']",28,10,18,0.3571428571428571,0.6428571428571429,2,6,0.9402859586706313,0
"['001011', '0', '1110000', '00', '0', '0', '000', '100', '00000']",29,7,22,0.2413793103448276,0.7586206896551724,2,9,0.7973265101474423,0
"['1000', '111', '010110', '010', '0000010', '101101', '10', '1', '001', '00']",37,16,21,0.4324324324324324,0.5675675675675675,4,7,0.9867867202680318,0
"['1010011', '01110', '0011', '1']",17,10,7,0.5882352941176471,0.4117647058823529,3,2,0.9774178175281716,1
"['00101', '10', '1100', '11010', '010', '0011']",23,11,12,0.4782608695652174,0.5217391304347826,4,4,0.9986359641585718,1
"['10100', '1', '100', '1']",10,5,5,0.5,0.5,1,2,1.0,1
"['1110001', '010', '000100']",16,6,10,0.375,0.625,1,4,0.954434002924965,1
"['0101', '001', '1000000', '1']",15,5,10,0.3333333333333333,0.6666666666666666,1,4,0.9182958340544896,1
"['110', '10', '0101', '1110010']",16,9,7,0.5625,0.4375,3,2,0.9886994082884974,1
"['0110', '0', '10011', '0', '1100', '000000']",21,7,14,0.3333333333333333,0.6666666666666666,3,6,0.9182958340544896,0
"['011100', '101000', '01111']",17,9,8,0.5294117647058824,0.4705882352941176,3,3,0.9975025463691152,1
"['0000', '0', '1100']",9,2,7,0.2222222222222222,0.7777777777777778,1,3,0.7642045065086203,0
"['01110', '00001', '001100', '11101', '00101']",26,12,14,0.4615384615384615,0.5384615384615384,3,5,0.9957274520849256,1
"['1010101', '1010001', '1', '010001', '0', '010', '110000', '0', '111101']",38,18,20,0.4736842105263157,0.5263157894736842,5,5,0.9980008838722996,0
"['00111', '1', '111101']",12,9,3,0.75,0.25,4,1,0.8112781244591328,1
"['00111', '000', '0001101', '10111', '10', '001', '0111', '1', '1', '1']",32,18,14,0.5625,0.4375,8,5,0.9886994082884974,0
"['00101', '01', '0', '11', '010100']",16,7,9,0.4375,0.5625,1,2,0.9886994082884974,0
"['010100', '1010100', '111001', '11', '11011', '10', '110', '00011', '011', '111']",42,25,17,0.5952380952380952,0.4047619047619047,8,5,0.97366806454962,0
"['1', '00110', '0', '1001', '00', '0110', '1']",18,8,10,0.4444444444444444,0.5555555555555556,2,4,0.9910760598382222,0
"['0', '110111', '00001', '101011', '0', '01010', '1', '010000', '0']",32,14,18,0.4375,0.5625,4,5,0.9886994082884974,0
"['010011', '10', '11', '0000101', '100', '1010', '100', '1', '011', '110011']",37,19,18,0.5135135135135135,0.4864864864864865,6,6,0.9994730201859836,0
"['01', '1011111', '00110', '001010', '1']",21,12,9,0.5714285714285714,0.4285714285714285,4,2,0.9852281360342516,0
"['0011111', '0011', '11010', '00', '011', '1000', '1010110', '1', '1']",34,19,15,0.5588235294117647,0.4411764705882353,7,5,0.9899927915575186,0
"['1000', '00100', '001000', '1', '00', '0011', '0001', '011010', '1001011']",39,14,25,0.358974358974359,0.6410256410256411,3,9,0.9418285354475155,0
"['10111', '10101', '100', '010011', '1100', '00']",25,13,12,0.52,0.48,5,4,0.9988455359952018,1
"['110', '0011', '10', '1000010', '0111', '11100', '011', '1011']",32,18,14,0.5625,0.4375,7,5,0.9886994082884974,0
"['00110', '0', '100', '010001', '0', '110', '0110011']",26,11,15,0.4230769230769231,0.5769230769230769,4,6,0.9828586897127056,0
"['00101', '11101']",10,6,4,0.6,0.4,2,1,0.9709505944546686,1
"['0001001', '11100', '01', '000', '1', '10011', '00110', '11', '001']",33,15,18,0.4545454545454545,0.5454545454545454,6,7,0.9940302114769564,0
"['000', '1', '111']",7,4,3,0.5714285714285714,0.4285714285714285,2,1,0.9852281360342516,0
"['0', '0111', '1000', '00', '001010']",17,6,11,0.3529411764705882,0.6470588235294118,2,4,0.9366673818775626,0
"['110', '1000111', '10001', '10010', '1011101', '110']",30,17,13,0.5666666666666667,0.4333333333333333,6,3,0.9871377743721864,1
"['1011011', '001', '0010', '100', '00110']",22,10,12,0.4545454545454545,0.5454545454545454,3,4,0.9940302114769564,1
"['10', '1', '1100', '010', '1100011']",17,9,8,0.5294117647058824,0.4705882352941176,3,2,0.9975025463691152,0
['0011'],4,2,2,0.5,0.5,1,1,1.0,1
"['011010', '01001']",11,5,6,0.4545454545454545,0.5454545454545454,1,2,0.9940302114769564,1
"['1', '1', '1101011', '1011001', '01', '11100', '00010', '0']",29,16,13,0.5517241379310345,0.4482758620689655,6,4,0.9922666387194964,0
"['00100', '101', '10101']",13,6,7,0.4615384615384615,0.5384615384615384,1,2,0.9957274520849256,1
"['0010110', '0111110', '1010111', '010']",24,14,10,0.5833333333333334,0.4166666666666667,4,2,0.9798687566511528,1
"['1110', '1', '010101', '011111', '1', '11100', '10111', '0011', '10']",34,23,11,0.6764705882352942,0.3235294117647059,7,2,0.9081783472997051,0
"['1', '00']",3,1,2,0.3333333333333333,0.6666666666666666,0,1,0.9182958340544896,1
"['0', '000', '01']",6,1,5,0.1666666666666666,0.8333333333333334,0,2,0.6500224216483541,0
"['00100', '11011', '100011']",16,8,8,0.5,0.5,3,3,1.0,1
"['101010', '11101', '01', '101', '100']",19,11,8,0.5789473684210527,0.4210526315789473,3,1,0.9819407868640976,0
"['1001001', '001', '000010', '00', '0000']",22,5,17,0.2272727272727272,0.7727272727272727,0,8,0.7732266742876346,0
"['0111010', '110', '1', '1011110', '01', '01011', '10010']",30,18,12,0.6,0.4,6,2,0.9709505944546686,0
['1001'],4,2,2,0.5,0.5,0,1,1.0,1
"['1', '01100', '1011', '111111', '000', '101100', '0', '01111', '01101']",36,22,14,0.6111111111111112,0.3888888888888889,9,4,0.964078764808229,0
"['0101011', '00', '1001100', '010001']",22,9,13,0.4090909090909091,0.5909090909090909,2,4,0.9760206482366148,1
"['0111010', '0111', '101', '001100', '00010', '0', '1010100']",33,15,18,0.4545454545454545,0.5454545454545454,4,6,0.9940302114769564,0
"['0011111', '0']",8,5,3,0.625,0.375,2,1,0.954434002924965,1
"['1010111', '000110', '10001', '011110', '1', '100', '0010']",32,16,16,0.5,0.5,5,4,1.0,1
"['11010', '110001', '1010', '0001110', '111', '00']",27,14,13,0.5185185185185185,0.4814814814814814,5,4,0.9990102708804812,1
['01110'],5,3,2,0.6,0.4,1,0,0.9709505944546686,1
"['1', '00']",3,1,2,0.3333333333333333,0.6666666666666666,0,1,0.9182958340544896,1
"['1', '001100', '00011', '00', '01', '00', '011110', '1100011', '1111110', '1000']",42,21,21,0.5,0.5,9,7,1.0,0
"['10010', '10000', '1001111', '01', '1010101', '1101', '11000', '01110', '110111', '0']",47,26,21,0.5531914893617021,0.4468085106382978,8,6,0.9918207974218424,0
"['1010', '0010', '10011', '11000', '0010001', '0', '11010']",31,13,18,0.4193548387096774,0.5806451612903226,3,5,0.9811522341999132,0
"['00001', '00101']",10,3,7,0.3,0.7,0,3,0.8812908992306927,1
"['0', '0000', '0001', '010011', '0101110']",22,8,14,0.3636363636363636,0.6363636363636364,2,5,0.94566030460064,0
"['01', '00', '100', '1001', '11101', '11101', '1', '00011', '100101', '1']",34,19,15,0.5588235294117647,0.4411764705882353,7,5,0.9899927915575186,0
"['10010', '1001', '011001']",15,7,8,0.4666666666666667,0.5333333333333333,1,3,0.9967916319816366,1
"['1', '00010', '110', '010']",12,5,7,0.4166666666666667,0.5833333333333334,1,2,0.9798687566511528,1
"['0', '11100', '1100111', '0100100']",20,10,10,0.5,0.5,3,4,1.0,1
"['1110', '1001']",8,5,3,0.625,0.375,1,1,0.954434002924965,1
"['0111', '10101', '101110', '11', '0110', '110111', '10']",29,20,9,0.6896551724137931,0.3103448275862069,9,0,0.8935711016541907,0
"['0011010', '01', '0101', '010']",16,7,9,0.4375,0.5625,1,2,0.9886994082884974,0
"['00', '100', '011110', '10000', '110011', '00']",24,10,14,0.4166666666666667,0.5833333333333334,4,6,0.9798687566511528,0
['1101'],4,3,1,0.75,0.25,1,0,0.8112781244591328,1
"['11', '1', '00001', '01']",10,5,5,0.5,0.5,1,2,1.0,0
['1'],1,1,0,1.0,0.0,0,0,-0.0,1
"['1111', '1', '10000']",10,6,4,0.6,0.4,3,2,0.9709505944546686,0
"['100111', '1001', '010101']",16,9,7,0.5625,0.4375,2,2,0.9886994082884974,1
"['101111', '0111100', '00', '10']",17,10,7,0.5882352941176471,0.4117647058823529,4,2,0.9774178175281716,1
"['11100', '0', '0011', '101', '01', '011', '00', '101', '0001110', '111']",33,18,15,0.5454545454545454,0.4545454545454545,5,4,0.9940302114769564,0
"['1', '111', '1011', '01', '1100', '10111', '001', '1001', '100000']",32,18,14,0.5625,0.4375,7,5,0.9886994082884974,0
"['110111', '0', '1101', '1', '1000000']",19,10,9,0.5263157894736842,0.4736842105263157,4,3,0.9980008838722996,0
"['10101', '00100', '1', '1', '01', '1000', '0010', '0011', '1111100']",33,16,17,0.4848484848484848,0.5151515151515151,5,6,0.9993375041688848,0
"['110010', '0', '010', '0100']",14,5,9,0.3571428571428571,0.6428571428571429,1,4,0.9402859586706313,0
"['00', '11', '1', '000', '101001', '010101']",20,9,11,0.45,0.55,1,3,0.9927744539878084,0
"['00100', '00111', '1', '11101', '01', '0']",19,10,9,0.5263157894736842,0.4736842105263157,3,3,0.9980008838722996,0
"['10', '110', '1', '0110011', '000010']",19,9,10,0.4736842105263157,0.5263157894736842,3,3,0.9980008838722996,0
"['0100001', '10', '001110', '10', '0', '0', '0']",20,7,13,0.35,0.65,2,5,0.934068055375491,0
['01101'],5,3,2,0.6,0.4,1,0,0.9709505944546686,1
"['10', '1011', '000', '10001', '1010', '00110', '001', '1', '100', '0111011']",37,18,19,0.4864864864864865,0.5135135135135135,6,5,0.9994730201859836,0
"['0', '11', '01', '000', '1100', '0010', '1001110']",23,10,13,0.4347826086956521,0.5652173913043478,3,4,0.9876925088958034,0
"['011', '101', '110', '0001000']",16,7,9,0.4375,0.5625,2,3,0.9886994082884974,1
['111100'],6,4,2,0.6666666666666666,0.3333333333333333,2,1,0.9182958340544896,1
"['101', '011', '10101']",11,7,4,0.6363636363636364,0.3636363636363636,1,0,0.94566030460064,1
"['10101', '110011', '10110', '0000111', '00111', '0', '011110', '01111']",40,24,16,0.6,0.4,9,6,0.9709505944546686,0
"['110', '010', '1000', '00']",12,4,8,0.3333333333333333,0.6666666666666666,1,3,0.9182958340544896,1
"['1100100', '101001']",13,6,7,0.4615384615384615,0.5384615384615384,1,3,0.9957274520849256,1
"['1100', '11', '001', '0', '10', '1010101', '11', '0', '0010', '1']",27,14,13,0.5185185185185185,0.4814814814814814,3,3,0.9990102708804812,0
"['10000', '100111', '0110001', '0111', '1100', '0', '0']",28,13,15,0.4642857142857143,0.5357142857142857,4,6,0.996316519558962,0
"['101', '10011', '111000', '101', '100101']",23,13,10,0.5652173913043478,0.4347826086956521,4,3,0.9876925088958034,1
"['00', '001101']",8,3,5,0.375,0.625,1,2,0.954434002924965,1
"['1', '001', '0100011', '001111', '01000', '00010', '111100', '00101', '101110', '001']",47,22,25,0.4680851063829787,0.5319148936170213,7,9,0.9970590569034106,0
"['1001', '10', '011', '0111', '00100']",18,9,9,0.5,0.5,3,4,1.0,1
['100'],3,1,2,0.3333333333333333,0.6666666666666666,0,1,0.9182958340544896,1
"['010', '000000', '1']",10,2,8,0.2,0.8,0,3,0.7219280948873623,1
"['0110', '011010', '1110', '00', '01', '00', '1100100', '10', '10', '1001']",35,16,19,0.4571428571428571,0.5428571428571428,4,7,0.9946937953613058,0
"['001011', '011110', '1000', '10', '00', '0110', '1000', '110', '100', '1111110']",41,21,20,0.5121951219512195,0.4878048780487805,8,6,0.9995708393473224,0
"['0', '101011']",7,4,3,0.5714285714285714,0.4285714285714285,1,0,0.9852281360342516,1
"['00', '001', '010', '111']",11,5,6,0.4545454545454545,0.5454545454545454,1,2,0.9940302114769564,1
"['10011', '0110']",9,5,4,0.5555555555555556,0.4444444444444444,2,1,0.9910760598382222,1
"['00', '1001', '01', '1', '101101', '10', '1110010', '11011']",29,17,12,0.5862068965517241,0.4137931034482758,6,3,0.9784493292686188,0
"['0111', '00', '011111']",12,8,4,0.6666666666666666,0.3333333333333333,3,1,0.9182958340544896,1
"['1', '0', '11011', '10', '110', '110100', '01', '001111']",26,16,10,0.6153846153846154,0.3846153846153846,6,2,0.961236604722876,0
"['11100', '00']",7,3,4,0.4285714285714285,0.5714285714285714,1,2,0.9852281360342516,1
"['01100', '1', '1001', '100100', '00', '001', '0110', '1110010', '00100', '01001']",42,17,25,0.4047619047619047,0.5952380952380952,5,10,0.97366806454962,0
"['1', '010111', '10101', '0000001', '1', '00', '0', '110', '1110', '10011']",35,18,17,0.5142857142857142,0.4857142857142857,6,5,0.9994110647387552,0
"['1', '00', '110']",6,3,3,0.5,0.5,1,1,1.0,1
"['010011', '1000']",10,4,6,0.4,0.6,1,2,0.9709505944546686,1
"['0100011', '00', '0010', '01111', '011111', '0']",25,13,12,0.52,0.48,5,4,0.9988455359952018,0
"['10001', '011000', '100', '10', '10100']",21,8,13,0.3809523809523809,0.6190476190476191,1,4,0.9587118829771318,0
['1101100'],7,4,3,0.5714285714285714,0.4285714285714285,2,1,0.9852281360342516,1
"['10', '0001', '1101', '000', '010010', '0', '00111', '0010001', '1101']",36,15,21,0.4166666666666667,0.5833333333333334,3,9,0.9798687566511528,0
"['00011', '1010', '11000', '00101', '110010', '0000', '001']",32,12,20,0.375,0.625,3,7,0.954434002924965,1
"['0010', '010']",7,2,5,0.2857142857142857,0.7142857142857143,0,2,0.863120568566631,1
"['001', '11110', '01', '11101', '000', '0100', '11', '110101', '11001']",35,20,15,0.5714285714285714,0.4285714285714285,7,6,0.9852281360342516,0
"['01', '111', '001', '00100', '0', '111101', '0010001']",27,13,14,0.4814814814814814,0.5185185185185185,4,5,0.9990102708804812,0
"['1', '00010', '0101', '0111', '001']",17,8,9,0.4705882352941176,0.5294117647058824,1,3,0.9975025463691152,1
"['1100', '000', '00']",9,2,7,0.2222222222222222,0.7777777777777778,1,3,0.7642045065086203,0
"['00', '10000', '0100110', '0', '1001', '011', '10', '101110', '111']",33,16,17,0.4848484848484848,0.5151515151515151,4,6,0.9993375041688848,0
"['0101', '1101', '1110']",12,8,4,0.6666666666666666,0.3333333333333333,3,0,0.9182958340544896,1
"['1011', '0111110', '111', '0011']",18,13,5,0.7222222222222222,0.2777777777777778,5,1,0.8524051786494786,1
"['1', '01']",3,2,1,0.6666666666666666,0.3333333333333333,0,0,0.9182958340544896,1
"['10100', '11011', '10']",12,7,5,0.5833333333333334,0.4166666666666667,2,1,0.9798687566511528,1
"['0', '110', '1', '011', '0010011', '111', '00000']",23,11,12,0.4782608695652174,0.5217391304347826,4,4,0.9986359641585718,0
"['00', '11', '11', '100', '101110', '1000000', '00', '110', '01']",29,13,16,0.4482758620689655,0.5517241379310345,4,7,0.9922666387194964,0
"['000000', '111111', '011111', '11', '110', '101', '0', '0100']",31,18,13,0.5806451612903226,0.4193548387096774,7,5,0.9811522341999132,0
"['100', '01', '110']",8,4,4,0.5,0.5,1,1,1.0,1
"['1100011', '0000111', '001', '0', '111010', '011', '1100110', '0', '1000010', '100']",45,21,24,0.4666666666666667,0.5333333333333333,7,10,0.9967916319816366,0
"['0001', '1', '1101111', '1111110', '000111', '0011', '00', '0']",32,19,13,0.59375,0.40625,9,5,0.9744894033980523,0
"['01011', '000', '00', '11', '110', '1000101', '000', '110', '1001']",32,14,18,0.4375,0.5625,4,5,0.9886994082884974,0
"['00', '001', '10011', '1', '111100', '11010', '01']",24,13,11,0.5416666666666666,0.4583333333333333,5,5,0.99498482818597,0
"['1', '01', '1011111', '001', '01101', '0101110', '0110101']",32,20,12,0.625,0.375,6,2,0.954434002924965,0
"['1', '010', '110110', '00', '01', '1', '110', '0011011', '010110', '01010']",36,19,17,0.5277777777777778,0.4722222222222222,7,4,0.997772472089982,0
"['1101001', '11101', '1100101']",19,12,7,0.631578947368421,0.3684210526315789,4,2,0.9494520153879484,1
"['011101', '1']",7,5,2,0.7142857142857143,0.2857142857142857,2,0,0.863120568566631,1
"['000', '1100', '10']",9,3,6,0.3333333333333333,0.6666666666666666,1,2,0.9182958340544896,1
"['1100100', '1010', '1', '0100', '1101']",20,10,10,0.5,0.5,2,3,1.0,1
"['100', '10', '101', '1110', '111101', '00']",20,12,8,0.6,0.4,4,2,0.9709505944546686,0
"['010', '01', '111000', '1110101', '111', '1']",22,14,8,0.6363636363636364,0.3636363636363636,5,2,0.94566030460064,0
"['0', '101010']",7,3,4,0.4285714285714285,0.5714285714285714,0,0,0.9852281360342516,1
"['1110', '01', '0010', '01', '01110', '0']",18,9,9,0.5,0.5,2,4,1.0,0
['000100'],6,1,5,0.1666666666666666,0.8333333333333334,0,2,0.6500224216483541,1
"['1001', '010']",7,3,4,0.4285714285714285,0.5714285714285714,0,1,0.9852281360342516,1
"['0010', '1011100', '0']",12,5,7,0.4166666666666667,0.5833333333333334,1,2,0.9798687566511528,1
"['0000', '0101']",8,2,6,0.25,0.75,0,2,0.8112781244591328,1
"['1111000', '01001', '0111', '10000', '0', '11']",24,12,12,0.5,0.5,5,5,1.0,0
"['0101', '00101', '110', '0001100']",19,8,11,0.4210526315789473,0.5789473684210527,2,4,0.9819407868640976,1
"['111110', '0', '100', '01010', '001', '1', '000', '101', '0', '101101']",32,16,16,0.5,0.5,4,4,1.0,0
['00001'],5,1,4,0.2,0.8,0,2,0.7219280948873623,1
"['01', '1', '001', '1', '0', '1010', '0', '1001']",17,8,9,0.4705882352941176,0.5294117647058824,2,3,0.9975025463691152,0
"['011', '100', '011', '10000', '1']",15,7,8,0.4666666666666667,0.5333333333333333,2,3,0.9967916319816366,1
"['0110011', '10', '0000100', '101']",19,8,11,0.4210526315789473,0.5789473684210527,2,4,0.9819407868640976,1
"['11111', '1']",6,6,0,1.0,0.0,3,0,-0.0,0
"['001', '010001', '11', '011110', '0', '11', '00000', '10', '1000']",31,13,18,0.4193548387096774,0.5806451612903226,4,6,0.9811522341999132,0
['0101'],4,2,2,0.5,0.5,0,0,1.0,1
"['11', '100100', '110', '0111', '1', '1100001', '0001010', '011011', '10', '110110']",44,24,20,0.5454545454545454,0.4545454545454545,9,7,0.9940302114769564,0
"['11011', '10001', '0', '0001']",15,7,8,0.4666666666666667,0.5333333333333333,2,3,0.9967916319816366,0
"['001101', '1011100', '111', '0010100', '0', '0000', '0010', '001001', '011101', '11011']",49,23,26,0.4693877551020408,0.5306122448979592,7,9,0.9972943816462349,0
"['1', '1010', '1011', '100', '110111']",18,12,6,0.6666666666666666,0.3333333333333333,4,1,0.9182958340544896,0
"['0010001', '01000', '1011', '11100', '1111', '1110010', '111000', '1110101', '010000']",51,26,25,0.5098039215686274,0.4901960784313725,7,8,0.9997226475394072,1
"['0', '001', '10000']",9,2,7,0.2222222222222222,0.7777777777777778,1,3,0.7642045065086203,0
"['1110110', '1000101', '100011', '1011', '1', '000']",28,15,13,0.5357142857142857,0.4642857142857143,5,3,0.996316519558962,0
"['100', '1111000', '1111', '0100110', '11', '0100', '001', '0001011', '1010101']",44,23,21,0.5227272727272727,0.4772727272727273,7,6,0.9985090989176322,0
"['011001', '0111001', '001010', '0111', '1000010']",30,14,16,0.4666666666666667,0.5333333333333333,4,6,0.9967916319816366,1
"['011', '000', '111100', '000']",15,6,9,0.4,0.6,3,3,0.9709505944546686,1
"['110111', '111', '1001', '0111011', '11', '0001011', '1000101', '00', '0001', '0001100']",49,26,23,0.5306122448979592,0.4693877551020408,9,7,0.9972943816462349,0
"['001', '000', '0010100']",13,3,10,0.2307692307692307,0.7692307692307693,0,4,0.7793498372920851,1
"['1100', '1111100', '0', '011', '10100']",20,11,9,0.55,0.45,4,4,0.9927744539878084,0
"['01', '1010111', '00', '11']",13,8,5,0.6153846153846154,0.3846153846153846,3,1,0.961236604722876,1
"['1010101', '001000', '0100001', '100101', '11', '110110']",34,16,18,0.4705882352941176,0.5294117647058824,4,6,0.9975025463691152,1
"['0111100', '001100']",13,6,7,0.4615384615384615,0.5384615384615384,3,3,0.9957274520849256,1
"['11', '0000111', '001101', '1', '100101', '0110', '10', '1', '1110', '111']",36,22,14,0.6111111111111112,0.3888888888888889,8,4,0.964078764808229,0
['1'],1,1,0,1.0,0.0,0,0,-0.0,1
"['0101', '01010', '11', '1', '01010', '0', '10101', '1000100', '0', '10101']",36,17,19,0.4722222222222222,0.5277777777777778,2,3,0.997772472089982,0
"['10100', '0001101', '010100', '1011000', '111011', '10', '1110', '110110', '000']",46,23,23,0.5,0.5,7,6,1.0,0
"['1001001', '1', '0011', '01', '001110', '000', '10', '01101']",30,14,16,0.4666666666666667,0.5333333333333333,4,7,0.9967916319816366,0
"['1', '0101', '10110', '01']",12,7,5,0.5833333333333334,0.4166666666666667,2,1,0.9798687566511528,0
"['0', '01', '0111000', '0101110', '000001', '0', '100110', '01001', '0101101', '01']",44,19,25,0.4318181818181818,0.5681818181818182,4,9,0.9865446300055644,0
"['11', '0', '1', '01', '1000010', '1', '1011', '1', '11', '0011']",25,15,10,0.6,0.4,6,3,0.9709505944546686,0
"['011000', '1110101', '010']",16,8,8,0.5,0.5,2,1,1.0,1
['100'],3,1,2,0.3333333333333333,0.6666666666666666,0,1,0.9182958340544896,1
"['1', '000', '001', '101000', '011010', '0000100', '00', '0110', '100101', '0100111']",45,17,28,0.3777777777777777,0.6222222222222222,4,10,0.9564574047992594,0
"['0', '000010', '110000', '0111000', '0111111', '10', '010001', '01', '10', '0111011']",46,22,24,0.4782608695652174,0.5217391304347826,8,9,0.9986359641585718,0
"['1', '1', '1', '110', '11001', '00', '00', '0111', '0010101', '0001100']",33,16,17,0.4848484848484848,0.5151515151515151,5,6,0.9993375041688848,0
"['01', '101', '11', '0100001', '0000001', '01', '1101', '0100']",31,13,18,0.4193548387096774,0.5806451612903226,3,6,0.9811522341999132,0
"['1010', '00100', '0100001', '001', '011110']",25,10,15,0.4,0.6,2,5,0.9709505944546686,1
"['101011', '1110001', '10111', '011', '11011', '1', '010111', '1100111']",40,28,12,0.7,0.3,10,2,0.8812908992306927,0
"['0', '11', '01011', '01100', '100000']",19,8,11,0.4210526315789473,0.5789473684210527,3,3,0.9819407868640976,0
"['1001', '10', '11001', '011010', '11', '11', '100', '011', '1000', '011100']",37,20,17,0.5405405405405406,0.4594594594594595,7,6,0.9952525494396792,0
"['00', '11', '000110', '1010']",14,6,8,0.4285714285714285,0.5714285714285714,2,2,0.9852281360342516,1
"['0010000', '010011', '0100', '11', '001101']",25,10,15,0.4,0.6,3,6,0.9709505944546686,0
"['1101', '0111011', '1', '01011']",17,12,5,0.7058823529411765,0.2941176470588235,4,0,0.8739810481273578,0
"['10', '1010']",6,3,3,0.5,0.5,0,0,1.0,0
"['1', '0000011', '01001', '011001', '10']",21,9,12,0.4285714285714285,0.5714285714285714,3,4,0.9852281360342516,1
"['1100100', '1111000', '111']",17,10,7,0.5882352941176471,0.4117647058823529,4,3,0.9774178175281716,1
"['0011101', '1001010']",14,7,7,0.5,0.5,2,2,1.0,1
"['1101', '10', '000000', '001100']",18,6,12,0.3333333333333333,0.6666666666666666,3,5,0.9182958340544896,1
"['1', '10', '1000', '00001', '1']",13,5,8,0.3846153846153846,0.6153846153846154,2,3,0.961236604722876,1
"['0011', '000111', '1010', '1', '0101', '1011101', '1', '0']",28,16,12,0.5714285714285714,0.4285714285714285,6,2,0.9852281360342516,0
"['00100', '1000001', '00001']",17,4,13,0.2352941176470588,0.7647058823529411,0,6,0.7871265862012691,1
"['0001', '0010', '111101', '0', '0000010', '111011']",28,13,15,0.4642857142857143,0.5357142857142857,4,5,0.996316519558962,0
"['01', '000001', '010110', '00001']",19,6,13,0.3157894736842105,0.6842105263157895,1,4,0.8997437586982626,1
"['0101', '0000111', '1', '11101', '010', '0111111', '010000']",33,18,15,0.5454545454545454,0.4545454545454545,6,5,0.9940302114769564,0
"['1001111', '00011', '1100', '11', '10', '00']",22,12,10,0.5454545454545454,0.4545454545454545,5,4,0.9940302114769564,0
"['0', '10', '0100010', '10010', '010', '0011', '0110010']",29,11,18,0.3793103448275862,0.6206896551724138,2,6,0.9575534837147482,0
"['1110101', '01001', '00001', '000100', '01011', '100111', '0010', '1000000', '011']",48,20,28,0.4166666666666667,0.5833333333333334,4,10,0.9798687566511528,1
"['1000010', '11101', '1100']",16,8,8,0.5,0.5,2,3,1.0,1
"['0101111', '0010', '0010', '0110101', '1110', '110011', '1011110', '11101']",44,27,17,0.6136363636363636,0.3863636363636363,10,4,0.9624127354629924,1
"['1010', '110', '0001', '011010', '00100', '1010000', '0111000', '0001100', '0']",44,16,28,0.3636363636363636,0.6363636363636364,4,10,0.94566030460064,0
"['10001', '0', '001101', '0110', '1010', '10100', '111011']",31,16,15,0.5161290322580645,0.4838709677419355,4,3,0.9992492479956564,0
"['1100', '001']",7,3,4,0.4285714285714285,0.5714285714285714,1,2,0.9852281360342516,1
"['1110', '110', '1', '0010']",12,7,5,0.5833333333333334,0.4166666666666667,2,1,0.9798687566511528,0
"['0010101', '101110']",13,7,6,0.5384615384615384,0.4615384615384615,2,1,0.9957274520849256,1
"['11110', '0010', '0010', '1000', '1111', '101']",24,13,11,0.5416666666666666,0.4583333333333333,4,3,0.99498482818597,1
['111'],3,3,0,1.0,0.0,1,0,-0.0,1
"['001111', '000111', '11', '10000', '001011', '11100', '10110', '111010', '0011']",45,25,20,0.5555555555555556,0.4444444444444444,10,7,0.9910760598382222,0
['110'],3,2,1,0.6666666666666666,0.3333333333333333,1,0,0.9182958340544896,1
"['01010', '1010011', '0000010']",19,7,12,0.3684210526315789,0.631578947368421,1,3,0.9494520153879484,1
"['0010000', '001111', '11', '1110', '0']",20,10,10,0.5,0.5,4,5,1.0,0
"['10', '1011011']",9,6,3,0.6666666666666666,0.3333333333333333,2,0,0.9182958340544896,1
"['00', '11', '11', '11']",8,6,2,0.75,0.25,3,1,0.8112781244591328,1
"['1011000', '1', '0100010', '01101', '010', '1100110', '110001', '0011010']",43,20,23,0.4651162790697674,0.5348837209302325,6,6,0.996485989886783,0
"['0111', '1101000', '0011100', '0001', '0']",23,10,13,0.4347826086956521,0.5652173913043478,3,4,0.9876925088958034,0
"['11110', '0000011', '00100', '1110', '01111', '0100', '0', '100101']",37,18,19,0.4864864864864865,0.5135135135135135,6,8,0.9994730201859836,0
"['0100', '10', '000', '0110010']",16,5,11,0.3125,0.6875,1,4,0.8960382325345574,1
"['0010100', '101000', '0101', '0', '01', '0100011', '0', '011', '00001']",36,13,23,0.3611111111111111,0.6388888888888888,2,9,0.943601631299382,0
"['1', '1', '100']",5,3,2,0.6,0.4,1,1,0.9709505944546686,1
"['0111011', '0', '00', '01001', '000', '0100000', '101', '000']",31,10,21,0.3225806451612903,0.6774193548387096,2,8,0.907165767573082,0
"['101', '110110', '1']",10,7,3,0.7,0.3,2,0,0.8812908992306927,0
"['100011', '1100']",10,5,5,0.5,0.5,2,2,1.0,1
"['1010011', '110010', '110110', '111010', '01', '10100', '0101', '10011', '0011100']",48,26,22,0.5416666666666666,0.4583333333333333,9,7,0.99498482818597,0
"['0011', '010', '0', '10', '010', '0']",14,5,9,0.3571428571428571,0.6428571428571429,1,4,0.9402859586706313,0
"['1101111', '0', '01101', '1100101', '1', '00010', '11']",28,17,11,0.6071428571428571,0.3928571428571428,7,3,0.9666186325481028,0
['1000111'],7,4,3,0.5714285714285714,0.4285714285714285,1,1,0.9852281360342516,1
"['1000', '010110']",10,4,6,0.4,0.6,1,2,0.9709505944546686,1
"['10', '11000', '00001', '00', '0001', '000010']",24,6,18,0.25,0.75,1,7,0.8112781244591328,0
['1'],1,1,0,1.0,0.0,0,0,-0.0,1
"['1100001', '11', '0110111', '100', '0100110', '000111', '0100101', '1100110']",46,24,22,0.5217391304347826,0.4782608695652174,9,8,0.9986359641585718,1
['01001'],5,2,3,0.4,0.6,0,1,0.9709505944546686,1
"['01', '10101', '00101']",12,6,6,0.5,0.5,1,1,1.0,1
"['001', '10', '00', '00', '1000', '001110', '11']",21,8,13,0.3809523809523809,0.6190476190476191,3,5,0.9587118829771318,0
"['100', '11', '0001', '11', '0010']",15,7,8,0.4666666666666667,0.5333333333333333,2,3,0.9967916319816366,1
"['1111010', '10']",9,6,3,0.6666666666666666,0.3333333333333333,2,0,0.9182958340544896,1
"['0000', '1', '0000011', '1111', '100000']",22,8,14,0.3636363636363636,0.6363636363636364,3,6,0.94566030460064,0
"['01', '10100']",7,3,4,0.4285714285714285,0.5714285714285714,1,1,0.9852281360342516,1
['0001010'],7,2,5,0.2857142857142857,0.7142857142857143,0,1,0.863120568566631,1
"['110010', '001001', '00011', '0', '010111', '1']",25,12,13,0.48,0.52,4,5,0.9988455359952018,0
"['10', '1', '1', '11', '01111', '00011', '111001', '1', '000100']",29,17,12,0.5862068965517241,0.4137931034482758,7,4,0.9784493292686188,0
"['0100', '1111', '111', '0111100', '011010', '0001', '111', '0101100']",38,22,16,0.5789473684210527,0.4210526315789473,9,5,0.9819407868640976,0
"['11111', '0', '00101', '001', '0001', '1', '0', '1100', '0100']",28,13,15,0.4642857142857143,0.5357142857142857,4,5,0.996316519558962,0
"['000111', '101', '0101110', '1', '011']",20,12,8,0.6,0.4,4,1,0.9709505944546686,0
"['1001', '000', '1000', '111']",14,6,8,0.4285714285714285,0.5714285714285714,1,3,0.9852281360342516,1
"['11000', '101', '000111']",14,7,7,0.5,0.5,2,2,1.0,1
"['0101', '101001', '1', '01', '00110', '101', '011100', '00100']",32,15,17,0.46875,0.53125,4,5,0.9971803988942642,0
"['1', '110', '0', '1000']",9,4,5,0.4444444444444444,0.5555555555555556,1,2,0.9910760598382222,0
"['0', '0111010', '10101', '0001', '1100010']",24,11,13,0.4583333333333333,0.5416666666666666,2,3,0.99498482818597,1
"['1', '00011']",6,3,3,0.5,0.5,1,1,1.0,1
"['100', '1000000', '011', '110010', '101010']",25,10,15,0.4,0.6,2,5,0.9709505944546686,1
"['01', '010110']",8,4,4,0.5,0.5,1,0,1.0,1
"['1111', '1010', '0', '110', '0000', '1', '11', '1110001', '0000111', '1']",34,19,15,0.5588235294117647,0.4411764705882353,8,6,0.9899927915575186,0
"['00', '10', '1101', '00011', '1']",14,7,7,0.5,0.5,2,2,1.0,0
"['00010', '10100', '011110', '0100', '00', '1101000', '01100', '01']",36,14,22,0.3888888888888889,0.6111111111111112,4,8,0.964078764808229,0
['1010010'],7,3,4,0.4285714285714285,0.5714285714285714,0,1,0.9852281360342516,1
"['01', '1001', '0', '0111101', '010000', '11010', '00010', '01000', '10', '11']",39,17,22,0.4358974358974359,0.5641025641025641,5,8,0.98811083652183,0
"['1000', '01100', '011011', '0']",16,7,9,0.4375,0.5625,3,3,0.9886994082884974,1
"['1', '1111001']",8,6,2,0.75,0.25,2,1,0.8112781244591328,1
['0001010'],7,2,5,0.2857142857142857,0.7142857142857143,0,1,0.863120568566631,1
"['1100', '10011', '0101001', '1010', '0001010', '111']",30,15,15,0.5,0.5,4,5,1.0,1
"['010', '0', '0110', '111010', '00011', '0', '0', '0']",22,9,13,0.4090909090909091,0.5909090909090909,3,4,0.9760206482366148,0
"['0101111', '00', '011', '10110', '00100']",22,11,11,0.5,0.5,4,3,1.0,1
"['0100', '1010', '111101', '0101', '01', '1010']",24,13,11,0.5416666666666666,0.4583333333333333,3,1,0.99498482818597,0
['1'],1,1,0,1.0,0.0,0,0,-0.0,1
"['1110', '111', '0100101', '100000', '100100', '10011', '1011010', '01000', '100', '1010']",50,23,27,0.46,0.54,5,9,0.9953784388202256,0
"['011010', '1111', '11001', '01']",17,11,6,0.6470588235294118,0.3529411764705882,4,1,0.9366673818775626,1
"['1', '10', '01001']",8,4,4,0.5,0.5,1,2,1.0,1
"['101001', '0']",7,3,4,0.4285714285714285,0.5714285714285714,0,1,0.9852281360342516,1
"['1111111', '011', '101100', '00000', '1', '01', '0111', '000101', '001']",37,20,17,0.5405405405405406,0.4594594594594595,6,5,0.9952525494396792,0
"['0110101', '10011', '11010', '1010', '0011', '1111010']",32,19,13,0.59375,0.40625,7,2,0.9744894033980523,1
"['00100', '101110', '010', '1001011']",21,10,11,0.4761904761904761,0.5238095238095238,2,4,0.998363672593813,1
"['1100001', '1011010', '1100101', '01101', '011', '10100', '01', '000', '01']",41,20,21,0.4878048780487805,0.5121951219512195,6,6,0.9995708393473224,0
"['10000', '0', '11000', '000110', '00', '100', '01001', '10', '0']",30,9,21,0.3,0.7,3,9,0.8812908992306927,0
"['1', '101101', '00000', '11', '00011', '00110']",24,11,13,0.4583333333333333,0.5416666666666666,5,4,0.99498482818597,0
"['10', '101011', '1', '100', '101011', '1', '1110', '11', '111']",28,20,8,0.7142857142857143,0.2857142857142857,7,1,0.863120568566631,0
"['000111', '101', '01', '0110', '11110', '1100']",24,14,10,0.5833333333333334,0.4166666666666667,6,2,0.9798687566511528,0
"['101001', '0111', '01111', '11', '0', '10101', '0', '00']",26,15,11,0.5769230769230769,0.4230769230769231,4,2,0.9828586897127056,0
"['10110', '001111', '110111', '110']",20,14,6,0.7,0.3,6,1,0.8812908992306927,1
"['00', '0', '0001', '010', '0110010', '10111', '0100', '00', '01']",30,11,19,0.3666666666666666,0.6333333333333333,2,7,0.9480782435939056,0
"['10', '1111100', '1000101', '0011', '11100', '1111011']",32,20,12,0.625,0.375,7,4,0.954434002924965,1
"['1010', '11', '11110', '100010', '01', '00110', '1111111']",31,20,11,0.6451612903225806,0.3548387096774194,7,3,0.9383153522334068,0
"['10', '1', '1111000', '001010', '0101', '010110', '011001', '00111', '0111000']",44,22,22,0.5,0.5,6,7,1.0,0
"['01', '010', '0', '00', '1011', '001000', '00001']",23,7,16,0.3043478260869565,0.6956521739130435,1,6,0.8865408928220899,0
"['00', '011', '01']",7,3,4,0.4285714285714285,0.5714285714285714,1,1,0.9852281360342516,1
['00101'],5,2,3,0.4,0.6,0,1,0.9709505944546686,1
"['0111', '1010100']",11,6,5,0.5454545454545454,0.4545454545454545,2,1,0.9940302114769564,1
"['00', '0110', '1011', '00', '1', '0100100', '001', '01110', '00100', '0']",34,13,21,0.3823529411764705,0.6176470588235294,3,7,0.9596868937742168,0
"['100', '0101111', '0', '000', '0110101', '010']",24,11,13,0.4583333333333333,0.5416666666666666,3,3,0.99498482818597,0
"['1001', '0', '000', '0010111']",15,6,9,0.4,0.6,1,4,0.9709505944546686,0
"['1010', '1', '1011110', '0111', '0101', '00000']",25,13,12,0.52,0.48,4,3,0.9988455359952018,0
"['1110110', '01111', '100', '101001', '01000', '00110']",31,16,15,0.5161290322580645,0.4838709677419355,5,5,0.9992492479956564,1
"['10', '100', '0', '1001', '0100001']",17,6,11,0.3529411764705882,0.6470588235294118,0,4,0.9366673818775626,0
"['010100', '011000', '1111', '0101', '0111010', '01101']",32,17,15,0.53125,0.46875,5,3,0.9971803988942642,1
"['10101', '10010', '1110', '0110', '110011']",24,14,10,0.5833333333333334,0.4166666666666667,5,3,0.9798687566511528,1
"['1', '010', '10111', '110101', '11', '01100', '1', '0000000']",30,15,15,0.5,0.5,4,4,1.0,0
"['01', '00', '10011', '0', '0']",11,4,7,0.3636363636363636,0.6363636363636364,1,3,0.94566030460064,0
"['0', '1101', '011000', '1', '0', '1', '0', '0010001']",22,9,13,0.4090909090909091,0.5909090909090909,2,3,0.9760206482366148,0
"['01111', '110', '11', '11', '101001']",18,13,5,0.7222222222222222,0.2777777777777778,5,1,0.8524051786494786,0
"['0110101', '11', '11', '000', '10010', '011011']",25,14,11,0.56,0.44,5,3,0.9895875212220556,1
"['11', '0', '11110', '1010010', '00110', '1', '10', '00111', '11011']",33,20,13,0.6060606060606061,0.3939393939393939,8,3,0.9672947789468944,0
"['011100', '000']",9,3,6,0.3333333333333333,0.6666666666666666,1,2,0.9182958340544896,1
['11'],2,2,0,1.0,0.0,1,0,-0.0,1
"['10', '0', '0000111', '0', '00010']",16,5,11,0.3125,0.6875,1,5,0.8960382325345574,0
"['0', '000011', '011010', '0', '0100', '11', '11101', '110000', '000000', '100']",40,15,25,0.375,0.625,5,10,0.954434002924965,0
"['110', '100101', '1000111', '0', '00', '00', '1', '1', '1001111', '01010']",35,18,17,0.5142857142857142,0.4857142857142857,6,5,0.9994110647387552,0
"['00000', '1', '011', '0110000', '1', '11000', '0111', '1']",27,12,15,0.4444444444444444,0.5555555555555556,5,6,0.9910760598382222,0
"['1000111', '011', '1111000', '1010011']",24,14,10,0.5833333333333334,0.4166666666666667,5,3,0.9798687566511528,1
"['10101', '0011000', '01001', '011']",20,9,11,0.45,0.55,2,4,0.9927744539878084,1
"['10011', '011', '00', '00', '0001011', '000110']",25,10,15,0.4,0.6,4,5,0.9709505944546686,1
"['00000', '0', '001', '010', '11010', '11', '1100']",23,9,14,0.391304347826087,0.6086956521739131,3,5,0.9656361333706098,0
"['00111', '101', '11', '011110', '1001100']",23,14,9,0.6086956521739131,0.391304347826087,6,3,0.9656361333706098,1
"['10100', '1', '0', '1100110', '0001', '0000', '1000001', '1001']",33,12,21,0.3636363636363636,0.6363636363636364,3,9,0.94566030460064,0
"['110', '0001', '001', '01', '0010', '0111', '0011000', '01101', '1']",33,15,18,0.4545454545454545,0.5454545454545454,5,8,0.9940302114769564,0
"['1100100', '00111', '10001', '0000']",21,8,13,0.3809523809523809,0.6190476190476191,3,6,0.9587118829771318,1
"['10100', '111001', '11', '100100', '001', '00000', '1101011', '1']",35,17,18,0.4857142857142857,0.5142857142857142,5,7,0.9994110647387552,0
"['110101', '110110', '011', '1', '1000', '11']",22,14,8,0.6363636363636364,0.3636363636363636,6,2,0.94566030460064,0
"['1101000', '1100', '1101110', '011111', '110010', '0011011', '100000', '111', '01', '11']",50,29,21,0.58,0.42,11,7,0.9814538950336535,0
"['0000000', '1000', '0000010', '10100', '1111011', '0010', '0000000']",41,11,30,0.2682926829268293,0.7317073170731707,3,13,0.8390040613676977,1
"['011', '01111', '11', '001001', '01', '0011', '1101000', '010']",32,17,15,0.53125,0.46875,6,5,0.9971803988942642,0
"['111', '1010101', '001010', '1000110', '00000', '001010', '1101']",38,17,21,0.4473684210526316,0.5526315789473685,4,6,0.9919924034538556,1
['1'],1,1,0,1.0,0.0,0,0,-0.0,1
"['10', '1011111', '0010', '0001', '10', '1010000']",26,12,14,0.4615384615384615,0.5384615384615384,3,5,0.9957274520849256,1
"['10100', '001', '011', '100110', '1110010', '10', '1', '001', '01']",32,16,16,0.5,0.5,3,5,1.0,0
"['1', '110010', '110001', '11', '100', '111110', '01', '101011', '0101101', '011011']",45,28,17,0.6222222222222222,0.3777777777777777,11,4,0.9564574047992594,0
"['101111', '001', '00', '0']",12,6,6,0.5,0.5,2,2,1.0,0
"['0', '1', '0', '1', '110']",7,4,3,0.5714285714285714,0.4285714285714285,1,0,0.9852281360342516,0
"['00', '00100', '0', '0', '011100', '0']",16,4,12,0.25,0.75,1,5,0.8112781244591328,0
"['01100', '0011', '0', '1', '100', '110010']",20,9,11,0.45,0.55,4,4,0.9927744539878084,0
"['111111', '1']",7,7,0,1.0,0.0,3,0,-0.0,0
"['1010000', '101000', '010001', '101110', '10', '1101']",31,14,17,0.4516129032258064,0.5483870967741935,3,5,0.9932338197397066,1
"['1', '0100', '0010', '01', '00111']",16,7,9,0.4375,0.5625,1,4,0.9886994082884974,0
"['11', '00010', '1101110', '100', '1', '101', '001000', '1', '100', '00']",33,15,18,0.4545454545454545,0.5454545454545454,5,6,0.9940302114769564,0
"['110', '11010', '1110001']",15,9,6,0.6,0.4,3,1,0.9709505944546686,1
"['1001', '1', '1001100']",12,6,6,0.5,0.5,2,3,1.0,0
"['110', '011101', '010010', '11', '1001', '101101', '1011', '011']",34,21,13,0.6176470588235294,0.3823529411764705,8,3,0.9596868937742168,0
"['0', '1000011', '00010']",13,4,9,0.3076923076923077,0.6923076923076923,1,3,0.8904916402194913,1
"['1', '110101', '1100', '11', '1011', '10010', '100001', '1100', '0', '00100']",38,19,19,0.5,0.5,5,7,1.0,0
"['101101', '1', '0', '001', '0', '10']",14,7,7,0.5,0.5,2,1,1.0,0
"['1', '1', '1101', '1', '0', '01']",10,7,3,0.7,0.3,3,1,0.8812908992306927,0
"['100100', '0111111', '000', '11011']",21,12,9,0.5714285714285714,0.4285714285714285,5,3,0.9852281360342516,1
['111'],3,3,0,1.0,0.0,1,0,-0.0,1
['00'],2,0,2,0.0,1.0,0,1,-0.0,1
"['0', '0011011', '0', '111001', '1', '011011']",22,13,9,0.5909090909090909,0.4090909090909091,6,2,0.9760206482366148,0
"['1', '0111', '0011']",9,6,3,0.6666666666666666,0.3333333333333333,2,1,0.9182958340544896,1
"['000001', '000', '0010', '01101', '1001001', '000101', '110011', '111', '0', '1']",42,18,24,0.4285714285714285,0.5714285714285714,5,9,0.9852281360342516,0
"['0000', '1100100', '0101', '1101110', '01011', '011']",30,15,15,0.5,0.5,5,5,1.0,1
"['10', '00001', '01100']",12,4,8,0.3333333333333333,0.6666666666666666,1,3,0.9182958340544896,1
"['01', '0101', '1111']",10,7,3,0.7,0.3,2,0,0.8812908992306927,0
"['0110101', '111001', '11', '11011', '0101', '001011']",30,19,11,0.6333333333333333,0.3666666666666666,7,2,0.9480782435939056,0
"['10101', '111001', '10000', '11', '00011', '011', '11', '111', '0100']",35,20,15,0.5714285714285714,0.4285714285714285,8,5,0.9852281360342516,0
['11101'],5,4,1,0.8,0.2,1,0,0.7219280948873623,1
"['11100', '010110']",11,6,5,0.5454545454545454,0.4545454545454545,2,1,0.9940302114769564,1
"['1', '011001', '1101', '10', '0', '00001', '1', '000', '1100', '1100100']",34,15,19,0.4411764705882353,0.5588235294117647,6,8,0.9899927915575186,0
"['01', '1001', '0010101']",13,6,7,0.4615384615384615,0.5384615384615384,1,2,0.9957274520849256,1
"['10', '0010101', '1101', '010']",16,8,8,0.5,0.5,1,1,1.0,1
"['10', '1011', '0', '1']",8,5,3,0.625,0.375,1,0,0.954434002924965,0
"['0000000', '101100', '11', '0110101', '0', '1', '001', '000', '011100']",36,14,22,0.3888888888888889,0.6111111111111112,4,8,0.964078764808229,0
"['1', '01011', '00', '111110', '1001', '010101', '01010', '0011']",33,18,15,0.5454545454545454,0.4545454545454545,4,3,0.9940302114769564,0
"['0001', '11', '0', '1000100', '0110000', '0', '000111']",28,10,18,0.3571428571428571,0.6428571428571429,3,7,0.9402859586706313,0
"['00110', '1101', '111', '111', '101001', '01', '00', '00', '00000', '1011']",36,18,18,0.5,0.5,7,6,1.0,0
"['11100', '11110']",10,7,3,0.7,0.3,3,1,0.8812908992306927,1
"['0', '000111', '0', '01110', '111101', '0010']",23,12,11,0.5217391304347826,0.4782608695652174,4,4,0.9986359641585718,0
"['1', '11000', '10110', '100111', '101100', '00001', '1000']",32,15,17,0.46875,0.53125,6,6,0.9971803988942642,0
"['1', '010', '11', '1', '0', '0001011', '10', '1', '10010', '0']",24,12,12,0.5,0.5,3,4,1.0,0
"['10100', '0001011', '0011000']",19,7,12,0.3684210526315789,0.631578947368421,2,4,0.9494520153879484,1
"['101', '000101', '101', '0', '1000010', '1001', '0100', '10100']",33,13,20,0.3939393939393939,0.6060606060606061,1,6,0.9672947789468944,0
"['00', '01101']",7,3,4,0.4285714285714285,0.5714285714285714,1,1,0.9852281360342516,1
"['01001', '0001110', '10110', '10000', '0000', '0100']",30,10,20,0.3333333333333333,0.6666666666666666,2,7,0.9182958340544896,0
"['0', '10010', '0', '001', '01', '101', '101101', '01110', '0111011']",33,18,15,0.5454545454545454,0.4545454545454545,6,4,0.9940302114769564,0
"['111', '11100', '10111']",13,10,3,0.7692307692307693,0.2307692307692307,4,1,0.7793498372920851,1
"['00111', '11010', '1', '10', '10', '110', '0001', '1010110']",29,16,13,0.5517241379310345,0.4482758620689655,6,3,0.9922666387194964,0
"['1', '1010111', '0', '110']",12,8,4,0.6666666666666666,0.3333333333333333,3,0,0.9182958340544896,0
"['0010', '010', '1100010', '1001111']",21,10,11,0.4761904761904761,0.5238095238095238,3,4,0.998363672593813,1
"['0', '101', '0010', '010', '110', '01', '1011011', '10', '110010']",31,16,15,0.5161290322580645,0.4838709677419355,5,4,0.9992492479956564,0
"['000', '0', '1110011', '11', '1111111', '01101', '1001', '10']",31,20,11,0.6451612903225806,0.3548387096774194,9,4,0.9383153522334068,0
"['0010', '1111', '1011100']",15,9,6,0.6,0.4,3,2,0.9709505944546686,1
"['0110', '0010', '001001', '0000', '0', '00', '10000']",26,6,20,0.2307692307692307,0.7692307692307693,1,8,0.7793498372920851,0
"['1011110', '1010110', '11100', '11001', '1']",25,16,9,0.64,0.36,6,2,0.9426831892554922,0
"['011', '1', '0010', '01111']",13,8,5,0.6153846153846154,0.3846153846153846,3,2,0.961236604722876,0
['00100'],5,1,4,0.2,0.8,0,2,0.7219280948873623,1
"['1100', '110110', '00']",12,6,6,0.5,0.5,3,2,1.0,1
"['01001', '10111', '001', '110111', '11', '1101001', '01']",30,19,11,0.6333333333333333,0.3666666666666666,6,3,0.9480782435939056,0
"['11111', '0001011', '1011', '010', '1', '1001000', '001', '1001']",34,18,16,0.5294117647058824,0.4705882352941176,6,5,0.9975025463691152,0
"['10100', '000000', '00', '001', '1011', '0', '01']",23,7,16,0.3043478260869565,0.6956521739130435,2,7,0.8865408928220899,0
"['11101', '000110', '0011100', '0011001', '1101110', '1', '1001011', '01', '000101']",48,25,23,0.5208333333333334,0.4791666666666667,8,7,0.9987472979361685,0
"['1100', '10001', '0', '01', '1001', '000001', '00010', '1', '0011', '10010']",37,14,23,0.3783783783783784,0.6216216216216216,3,9,0.9568886656798212,0
"['1100', '1010111', '01', '111100', '1111']",23,16,7,0.6956521739130435,0.3043478260869565,6,2,0.8865408928220899,1
"['110', '0111', '0', '011', '01', '1110', '0', '11000', '0001011']",30,16,14,0.5333333333333333,0.4666666666666667,7,6,0.9967916319816366,0
"['0', '000', '11001', '0000']",13,3,10,0.2307692307692307,0.7692307692307693,1,5,0.7793498372920851,0
"['10', '010', '1000']",9,3,6,0.3333333333333333,0.6666666666666666,0,2,0.9182958340544896,1
"['111111', '1001', '10', '11000', '0', '1000']",22,12,10,0.5454545454545454,0.4545454545454545,5,4,0.9940302114769564,0
"['11', '1001110']",9,6,3,0.6666666666666666,0.3333333333333333,2,1,0.9182958340544896,1
"['0110', '111', '0011']",11,7,4,0.6363636363636364,0.3636363636363636,3,1,0.94566030460064,1
"['0100011', '0111', '0011100', '01001', '100101', '001111', '0', '00']",38,18,20,0.4736842105263157,0.5263157894736842,6,7,0.9980008838722996,0
"['0011', '10']",6,3,3,0.5,0.5,1,1,1.0,1
"['0000', '01100', '0110000', '11011']",21,8,13,0.3809523809523809,0.6190476190476191,4,5,0.9587118829771318,1
"['0111', '010111', '0101', '1100010']",21,12,9,0.5714285714285714,0.4285714285714285,3,1,0.9852281360342516,1
"['10', '01101', '0100011', '01', '11', '1', '00011', '11']",26,15,11,0.5769230769230769,0.4230769230769231,6,3,0.9828586897127056,0
['0'],1,0,1,0.0,1.0,0,0,-0.0,1
"['0', '00100']",6,1,5,0.1666666666666666,0.8333333333333334,0,2,0.6500224216483541,1
"['11', '011010', '0', '1111', '1', '0000100', '0', '011', '1011', '110']",32,18,14,0.5625,0.4375,7,5,0.9886994082884974,0
"['0110', '0110101', '010', '0111001', '1', '1000011', '011', '1']",33,18,15,0.5454545454545454,0.4545454545454545,6,5,0.9940302114769564,0
"['1010001', '0111', '1100', '00111', '00']",22,11,11,0.5,0.5,3,4,1.0,1
"['1110', '110']",7,5,2,0.7142857142857143,0.2857142857142857,2,0,0.863120568566631,1
"['0011101', '10']",9,5,4,0.5555555555555556,0.4444444444444444,2,1,0.9910760598382222,1
"['110000', '01001', '10']",13,5,8,0.3846153846153846,0.6153846153846154,2,3,0.961236604722876,1
"['011', '100100', '1', '0001']",14,6,8,0.4285714285714285,0.5714285714285714,1,3,0.9852281360342516,1
['010000'],6,1,5,0.1666666666666666,0.8333333333333334,0,2,0.6500224216483541,1
"['011011', '101111', '010']",15,10,5,0.6666666666666666,0.3333333333333333,4,0,0.9182958340544896,1
"['110', '1', '10', '0']",7,4,3,0.5714285714285714,0.4285714285714285,2,1,0.9852281360342516,0
"['0111', '1110', '00000', '0101', '100011', '001']",26,12,14,0.4615384615384615,0.5384615384615384,5,5,0.9957274520849256,1
"['01111', '0001010', '0', '110000', '0000', '110000', '111101']",35,15,20,0.4285714285714285,0.5714285714285714,6,8,0.9852281360342516,0
['001110'],6,3,3,0.5,0.5,1,1,1.0,1
"['0101011', '11', '10011']",14,9,5,0.6428571428571429,0.3571428571428571,3,1,0.9402859586706313,1
"['1010101', '1']",8,5,3,0.625,0.375,1,0,0.954434002924965,1
"['10101', '1011', '0100110', '1111', '0010', '10', '1010', '11', '10010']",37,21,16,0.5675675675675675,0.4324324324324324,6,3,0.9867867202680318,0
"['10110', '001', '000', '01', '110001', '1', '0', '10', '101', '0101']",30,14,16,0.4666666666666667,0.5333333333333333,3,4,0.9967916319816366,0
"['100100', '111', '0110', '001011', '10', '111110', '001']",30,17,13,0.5666666666666667,0.4333333333333333,5,4,0.9871377743721864,0
"['00', '11', '0000', '01001', '00010']",18,5,13,0.2777777777777778,0.7222222222222222,1,5,0.8524051786494786,0
"['11', '10100', '011', '111011', '0010', '1110', '111', '0001', '0110111', '00']",40,24,16,0.6,0.4,8,4,0.9709505944546686,0
"['0011001', '0', '1001011']",15,7,8,0.4666666666666667,0.5333333333333333,2,3,0.9967916319816366,1
['1'],1,1,0,1.0,0.0,0,0,-0.0,1
"['1', '1', '1110']",6,5,1,0.8333333333333334,0.1666666666666666,2,0,0.6500224216483541,1
"['00', '000', '11', '100000', '1110010', '101']",23,9,14,0.391304347826087,0.6086956521739131,2,5,0.9656361333706098,0
"['0000', '10111', '11']",11,6,5,0.5454545454545454,0.4545454545454545,2,2,0.9940302114769564,1
"['011110', '0111110', '1111', '1001', '101', '010000', '0100', '111000', '0111', '1110101']",51,30,21,0.5882352941176471,0.4117647058823529,11,7,0.9774178175281716,0
"['001101', '001', '1', '1000010', '01101', '010001', '1000110']",35,15,20,0.4285714285714285,0.5714285714285714,5,7,0.9852281360342516,1
['10110'],5,3,2,0.6,0.4,1,0,0.9709505944546686,1
"['0111001', '0', '0', '00', '0100011']",18,7,11,0.3888888888888889,0.6111111111111112,2,4,0.964078764808229,0
"['111', '011100', '01']",11,7,4,0.6363636363636364,0.3636363636363636,2,1,0.94566030460064,1
"['10000', '0010001', '0110001', '001', '01100']",27,9,18,0.3333333333333333,0.6666666666666666,2,7,0.9182958340544896,1
"['0', '01100', '11', '0011111', '00001', '011']",23,12,11,0.5217391304347826,0.4782608695652174,5,5,0.9986359641585718,0
['00011'],5,2,3,0.4,0.6,1,1,0.9709505944546686,1
"['101011', '111010', '111001', '1']",19,13,6,0.6842105263157895,0.3157894736842105,4,1,0.8997437586982626,0
"['0111', '1100', '100011', '11011', '111010', '011', '10100', '11010', '1000001']",45,25,20,0.5555555555555556,0.4444444444444444,8,6,0.9910760598382222,0
"['001000', '0111', '000110', '1111', '101', '0011100', '00000']",35,15,20,0.4285714285714285,0.5714285714285714,5,8,0.9852281360342516,1
"['01', '01']",4,2,2,0.5,0.5,0,0,1.0,1
"['101111', '000100', '1', '10', '1101101', '1100', '101', '1010', '010']",36,20,16,0.5555555555555556,0.4444444444444444,7,4,0.9910760598382222,0
"['0', '1001', '1010', '00010', '1100010']",21,8,13,0.3809523809523809,0.6190476190476191,2,4,0.9587118829771318,1
"['11', '11', '11000', '0011', '0001', '011', '10101', '0', '0100011', '01110']",38,20,18,0.5263157894736842,0.4736842105263157,7,5,0.9980008838722996,0
"['010', '1101110']",10,6,4,0.6,0.4,2,0,0.9709505944546686,1
['011001'],6,3,3,0.5,0.5,1,1,1.0,1
"['000101', '10', '1100', '1001011', '011001', '110', '010011', '0100', '011', '11001']",46,23,23,0.5,0.5,8,8,1.0,0
"['01', '0110100', '000', '000010', '000', '00111', '01']",28,9,19,0.3214285714285714,0.6785714285714286,2,7,0.9059282160429992,1
"['001', '1010', '1', '0', '010001', '010', '0100101', '11', '1101']",31,15,16,0.4838709677419355,0.5161290322580645,3,5,0.9992492479956564,0
"['00011', '1011', '101110', '0111', '01101', '0000', '1111']",32,19,13,0.59375,0.40625,7,4,0.9744894033980523,1
['010101'],6,3,3,0.5,0.5,0,0,1.0,1
"['101100', '11000', '0']",12,5,7,0.4166666666666667,0.5833333333333334,2,3,0.9798687566511528,1
"['10', '100', '111', '000', '00010', '00000', '011', '11110']",29,12,17,0.4137931034482758,0.5862068965517241,4,7,0.9784493292686188,0
"['11111', '00', '1', '00001', '01000']",18,8,10,0.4444444444444444,0.5555555555555556,2,4,0.9910760598382222,0
"['111', '010000', '11', '0010010']",18,8,10,0.4444444444444444,0.5555555555555556,2,4,0.9910760598382222,0
['1000'],4,1,3,0.25,0.75,0,1,0.8112781244591328,1
"['01', '011', '011', '110', '1000010', '1100', '10000', '011010', '00']",35,15,20,0.4285714285714285,0.5714285714285714,5,6,0.9852281360342516,0
"['110', '110110', '10101', '110010', '001110', '01000', '001001', '01011', '00']",44,21,23,0.4772727272727273,0.5227272727272727,6,7,0.9985090989176322,0
"['11100', '0', '00', '10', '110000', '0', '01', '011']",22,9,13,0.4090909090909091,0.5909090909090909,3,5,0.9760206482366148,0
"['101101', '1', '0', '0', '1011110', '11010']",21,13,8,0.6190476190476191,0.3809523809523809,5,1,0.9587118829771318,0
"['01110', '0100101', '1111000', '0110001', '1', '10']",29,15,14,0.5172413793103449,0.4827586206896552,5,5,0.9991421039919088,0
"['1101', '1', '00001', '0', '1111', '01', '010', '1111010', '0100011', '001']",37,20,17,0.5405405405405406,0.4594594594594595,7,5,0.9952525494396792,0
"['01', '11000', '0110', '111', '0', '001', '101110', '111111', '010100', '10']",38,22,16,0.5789473684210527,0.4210526315789473,8,4,0.9819407868640976,0
"['0000101', '0010000', '00111', '011010']",25,9,16,0.36,0.64,2,6,0.9426831892554922,1
"['011', '1', '01010', '1100', '0', '00011', '10', '0001011']",28,13,15,0.4642857142857143,0.5357142857142857,4,5,0.996316519558962,0
"['0010', '1110110', '110']",14,8,6,0.5714285714285714,0.4285714285714285,3,1,0.9852281360342516,1
"['011111', '10']",8,6,2,0.75,0.25,3,0,0.8112781244591328,1
"['1100', '101000', '1000101']",17,7,10,0.4117647058823529,0.5882352941176471,1,3,0.9774178175281716,1
"['000', '01101', '1101100', '0000', '0010011', '001', '00111', '010', '111', '0001']",44,19,25,0.4318181818181818,0.5681818181818182,6,10,0.9865446300055644,0
"['110', '010110', '0111', '1', '010', '11', '111', '11', '1111']",28,21,7,0.75,0.25,9,2,0.8112781244591328,0
"['1000010', '000011', '01000', '11100']",23,8,15,0.3478260869565217,0.6521739130434783,2,6,0.9321115676166748,1
"['0100111', '1110', '010100', '001']",20,10,10,0.5,0.5,3,4,1.0,1
"['110011', '000', '1', '1011110', '0000']",21,10,11,0.4761904761904761,0.5238095238095238,5,4,0.998363672593813,0
"['10', '1111000', '00', '1111100']",18,10,8,0.5555555555555556,0.4444444444444444,4,3,0.9910760598382222,1
"['11110', '1', '00', '0101111', '0', '0', '1000110', '101']",27,15,12,0.5555555555555556,0.4444444444444444,5,3,0.9910760598382222,0
"['0', '1101111', '1011']",12,9,3,0.75,0.25,4,0,0.8112781244591328,1
"['000011', '111011', '11', '111', '0100010', '011000', '11000', '11110', '00', '10011']",47,25,22,0.5319148936170213,0.4680851063829787,10,8,0.9970590569034106,0
"['01', '0101010', '011111']",15,9,6,0.6,0.4,2,1,0.9709505944546686,1
"['10', '1110011', '010101', '101010', '1', '10100', '101001', '11', '0100']",39,21,18,0.5384615384615384,0.4615384615384615,5,4,0.9957274520849256,0
"['01', '10001', '00111', '00001', '110111', '1101111', '1', '00', '0']",34,19,15,0.5588235294117647,0.4411764705882353,7,5,0.9899927915575186,0
"['00', '010', '01', '010', '0', '1', '0111', '0']",17,7,10,0.4117647058823529,0.5882352941176471,1,3,0.9774178175281716,0
"['101111', '0', '000', '0001111', '00000']",22,9,13,0.4090909090909091,0.5909090909090909,4,5,0.9760206482366148,0
"['1', '0111', '0001001', '1']",13,7,6,0.5384615384615384,0.4615384615384615,2,2,0.9957274520849256,1
"['11010', '0', '010', '0011', '10000', '0110001', '1101']",29,13,16,0.4482758620689655,0.5517241379310345,4,5,0.9922666387194964,0
"['010', '1', '00110', '0', '1111001', '00', '01', '0', '0110']",26,12,14,0.4615384615384615,0.5384615384615384,4,5,0.9957274520849256,0
"['1010111', '11001', '0101110', '110100', '011']",28,17,11,0.6071428571428571,0.3928571428571428,5,2,0.9666186325481028,1
"['011', '1111', '011000', '1']",14,9,5,0.6428571428571429,0.3571428571428571,4,1,0.9402859586706313,0
"['11', '01100', '0000110', '1111', '01', '010010', '01000', '10', '100']",36,16,20,0.4444444444444444,0.5555555555555556,5,7,0.9910760598382222,0
"['0111000', '100', '11', '000', '00', '101', '10']",22,9,13,0.4090909090909091,0.5909090909090909,3,4,0.9760206482366148,0
"['100101', '11', '1000001', '110101', '00001']",26,12,14,0.4615384615384615,0.5384615384615384,3,5,0.9957274520849256,1
"['110', '101111', '0001001', '000', '111']",22,12,10,0.5454545454545454,0.4545454545454545,4,3,0.9940302114769564,1
"['0', '0010', '000', '01']",10,2,8,0.2,0.8,0,3,0.7219280948873623,0
"['0010010', '001010', '11', '001', '10110', '100', '00', '1011001', '1000']",39,16,23,0.4102564102564102,0.5897435897435898,5,8,0.97663491144401,0
"['10', '1110', '00011', '0000110', '0100010']",25,10,15,0.4,0.6,3,6,0.9709505944546686,1
"['110000', '01', '000', '0', '1011010', '01101', '0000010', '10001', '110001']",42,16,26,0.3809523809523809,0.6190476190476191,4,9,0.9587118829771318,0
"['0010', '01101', '110', '11', '1001011', '0001011', '100111', '1', '0010', '10110']",44,24,20,0.5454545454545454,0.4545454545454545,8,6,0.9940302114769564,0
"['000011', '0011111', '011', '01100', '0010', '0001', '110']",32,15,17,0.46875,0.53125,6,7,0.9971803988942642,1
"['010000', '000', '0001000', '0', '000000', '1001010', '100', '1010', '1', '01']",40,10,30,0.25,0.75,0,12,0.8112781244591328,0
"['10101', '1']",6,4,2,0.6666666666666666,0.3333333333333333,1,0,0.9182958340544896,1
"['0100000', '010']",10,2,8,0.2,0.8,0,3,0.7219280948873623,1
"['1111', '00', '0']",7,4,3,0.5714285714285714,0.4285714285714285,2,1,0.9852281360342516,0
"['00101', '1', '10000', '100110', '00', '1000011']",26,10,16,0.3846153846153846,0.6153846153846154,3,7,0.961236604722876,0
['1001100'],7,3,4,0.4285714285714285,0.5714285714285714,1,2,0.9852281360342516,1
"['100', '1011111', '00011', '0', '11000', '100001', '011101', '1101', '100110', '1']",44,24,20,0.5454545454545454,0.4545454545454545,8,6,0.9940302114769564,0
"['1111010', '11', '001000', '100', '111111', '10100', '10110', '01001']",39,22,17,0.5641025641025641,0.4358974358974359,7,6,0.98811083652183,0
"['0001', '1110111', '1111', '01110', '011', '00', '1', '111111', '0000', '101010']",42,26,16,0.6190476190476191,0.3809523809523809,10,5,0.9587118829771318,0
"['1', '0000', '110111', '001', '001001', '00100', '000011', '111']",34,15,19,0.4411764705882353,0.5588235294117647,4,9,0.9899927915575186,0
"['1', '1', '01000', '0000111', '111', '001111', '0110001', '111']",33,19,14,0.5757575757575758,0.4242424242424242,9,5,0.9833761901392236,0
"['100010', '0001100']",13,4,9,0.3076923076923077,0.6923076923076923,1,4,0.8904916402194913,1
"['1000000', '1', '0', '111', '1101', '0011011', '0001', '0101101', '010111', '0']",41,21,20,0.5121951219512195,0.4878048780487805,6,5,0.9995708393473224,0
"['100', '101110', '100101', '001110', '010110', '01', '0111100']",36,19,17,0.5277777777777778,0.4722222222222222,5,6,0.997772472089982,0
"['11', '11001', '101111', '011', '0001011', '1010001', '1101', '00']",36,21,15,0.5833333333333334,0.4166666666666667,8,4,0.9798687566511528,0
"['1100111', '011001', '0001110', '101101', '01100', '001', '1']",35,19,16,0.5428571428571428,0.4571428571428571,7,5,0.9946937953613058,0
"['1111000', '11', '1011']",13,9,4,0.6923076923076923,0.3076923076923077,4,1,0.8904916402194913,1
"['01000', '001111', '1000', '00000', '011', '00111', '01101']",33,14,19,0.4242424242424242,0.5757575757575758,5,7,0.9833761901392236,1
"['101001', '1110', '01001', '1101', '1101']",23,14,9,0.6086956521739131,0.391304347826087,4,3,0.9656361333706098,1
"['0101111', '110110', '01', '011000']",21,12,9,0.5714285714285714,0.4285714285714285,5,2,0.9852281360342516,1
"['00', '0110', '0', '11101']",12,6,6,0.5,0.5,2,2,1.0,0
"['0110101', '01', '011', '0', '0']",14,7,7,0.5,0.5,2,1,1.0,0
"['11000', '0111', '0101110', '100', '00', '01100', '10011', '0110', '00', '101']",40,19,21,0.475,0.525,6,7,0.99819587904281,0
"['00', '1', '0110']",7,3,4,0.4285714285714285,0.5714285714285714,1,1,0.9852281360342516,1
"['0010100', '0010', '001', '111111', '1000100', '1111', '1', '10', '101']",37,20,17,0.5405405405405406,0.4594594594594595,7,6,0.9952525494396792,0
"['110', '1101', '1001', '0000010', '1111100', '1', '11100']",31,17,14,0.5483870967741935,0.4516129032258064,7,5,0.9932338197397066,0
['1'],1,1,0,1.0,0.0,0,0,-0.0,1
"['000011', '11100', '10', '1110011', '010000', '001', '10', '00', '0', '0']",35,14,21,0.4,0.6,5,9,0.9709505944546686,0
"['001000', '11110', '10011', '100000', '10', '10', '0011000', '1010100', '011']",43,18,25,0.4186046511627907,0.5813953488372093,5,8,0.9807983646944296,0
"['100', '0', '0001011']",11,4,7,0.3636363636363636,0.6363636363636364,1,3,0.94566030460064,1
"['100', '11001', '1001110', '110', '100', '00101']",26,13,13,0.5,0.5,4,5,1.0,1
"['01', '0101111', '10010', '110', '1111011', '01101']",29,19,10,0.6551724137931034,0.3448275862068966,7,1,0.9293636260137188,1
['1000001'],7,2,5,0.2857142857142857,0.7142857142857143,0,2,0.863120568566631,1
"['11001', '1', '10001']",11,6,5,0.5454545454545454,0.4545454545454545,2,2,0.9940302114769564,1
"['11101', '10', '0', '11', '11', '10110', '1', '11', '110111']",26,20,6,0.7692307692307693,0.2307692307692307,8,1,0.7793498372920851,0
['0101'],4,2,2,0.5,0.5,0,0,1.0,1
"['00000', '1111', '00100', '0101001', '0110', '111', '101000', '1']",35,16,19,0.4571428571428571,0.5428571428571428,5,6,0.9946937953613058,0
"['111', '11100']",8,6,2,0.75,0.25,3,1,0.8112781244591328,1
"['001010', '1111110']",13,8,5,0.6153846153846154,0.3846153846153846,3,1,0.961236604722876,1
"['010010', '1011', '1101011']",17,10,7,0.5882352941176471,0.4117647058823529,3,1,0.9774178175281716,1
"['0001010', '0111100', '0']",15,6,9,0.4,0.6,2,3,0.9709505944546686,1
"['000', '0001100', '101', '1', '0100', '10110', '010111', '01010']",34,15,19,0.4411764705882353,0.5588235294117647,4,6,0.9899927915575186,0
['10100'],5,2,3,0.4,0.6,0,1,0.9709505944546686,1
"['0', '1011001', '0', '010101', '000', '0']",19,7,12,0.3684210526315789,0.631578947368421,1,4,0.9494520153879484,0
"['110', '00111', '1110101', '11', '10', '1011011', '1', '11001', '0011001', '01000']",44,26,18,0.5909090909090909,0.4090909090909091,10,5,0.9760206482366148,0
"['10', '1', '11', '111110', '10111', '1111111', '1', '1010011', '001011']",37,28,9,0.7567567567567568,0.2432432432432432,12,2,0.8003922080453356,0
"['0001', '111', '01', '00']",11,5,6,0.4545454545454545,0.5454545454545454,2,2,0.9940302114769564,0
"['1110', '1011', '010001', '11', '0101', '001', '10100', '110000', '1']",35,18,17,0.5142857142857142,0.4857142857142857,5,5,0.9994110647387552,0
"['1001', '011']",7,4,3,0.5714285714285714,0.4285714285714285,1,1,0.9852281360342516,1
"['001110', '0', '101001', '001', '0000']",20,7,13,0.35,0.65,1,6,0.934068055375491,0
"['100', '0101000']",10,3,7,0.3,0.7,0,2,0.8812908992306927,1
"['1', '11100', '000', '1110001', '010', '0101']",23,11,12,0.4782608695652174,0.5217391304347826,3,4,0.9986359641585718,0
['000'],3,0,3,0.0,1.0,0,1,-0.0,1
"['011', '01', '00', '1', '00', '000110', '0111', '01']",22,10,12,0.4545454545454545,0.5454545454545454,3,4,0.9940302114769564,0
"['0111', '01', '111010', '1110', '110100']",22,14,8,0.6363636363636364,0.3636363636363636,5,1,0.94566030460064,1
"['101', '000110']",9,4,5,0.4444444444444444,0.5555555555555556,1,1,0.9910760598382222,1
"['100110', '11000', '11001', '11', '0111']",22,13,9,0.5909090909090909,0.4090909090909091,5,3,0.9760206482366148,1
"['1100', '111', '101']",10,7,3,0.7,0.3,3,1,0.8812908992306927,1
['0'],1,0,1,0.0,1.0,0,0,-0.0,1
"['1000010', '10100', '101001', '0', '0001001']",26,9,17,0.3461538461538461,0.6538461538461539,0,7,0.9305861291319928,1
"['0001010', '011011', '00000', '000110', '0000', '0101111', '111101', '0100011', '001011']",54,24,30,0.4444444444444444,0.5555555555555556,9,11,0.9910760598382222,0
"['1011', '111', '0111101', '011101', '001001', '11001']",31,20,11,0.6451612903225806,0.3548387096774194,6,3,0.9383153522334068,1
"['11', '0111', '0000', '11101', '0', '1000']",20,10,10,0.5,0.5,3,3,1.0,0
"['01', '001', '1101', '10111', '100111', '011010', '10', '1000010', '11']",37,21,16,0.5675675675675675,0.4324324324324324,7,4,0.9867867202680318,0
"['100001', '01010', '0101111', '1', '001001', '000110', '1000111', '1']",39,19,20,0.4871794871794871,0.5128205128205128,5,7,0.999525689293649,1
"['111111', '1010101', '111', '1']",17,14,3,0.8235294117647058,0.1764705882352941,5,0,0.6722948170756379,0
"['000010', '1', '100010', '0111']",17,7,10,0.4117647058823529,0.5882352941176471,2,4,0.9774178175281716,1
"['1', '0111001', '00011', '1101111']",20,13,7,0.65,0.35,5,2,0.934068055375491,1
"['11011', '0010', '011', '10110', '0110101', '0011111', '1000', '000']",38,20,18,0.5263157894736842,0.4736842105263157,8,7,0.9980008838722996,1
"['01', '001', '00011', '01', '000', '001', '011001', '10', '1110', '00']",32,13,19,0.40625,0.59375,4,6,0.9744894033980523,0
"['100011', '1011011', '1111011']",20,14,6,0.7,0.3,6,1,0.8812908992306927,1
['0101'],4,2,2,0.5,0.5,0,0,1.0,1
"['01100', '110100', '0', '1111', '000110']",22,11,11,0.5,0.5,5,3,1.0,0
"['0000010', '11', '1110']",13,6,7,0.4615384615384615,0.5384615384615384,2,2,0.9957274520849256,1
"['00011', '11', '101000', '00001', '0101110', '0001', '00', '0110', '00010', '001']",43,16,27,0.3720930232558139,0.627906976744186,4,10,0.9522656254366642,0
"['1110', '010', '0101111', '011111', '111100', '1000']",30,19,11,0.6333333333333333,0.3666666666666666,7,4,0.9480782435939056,1
"['10110', '0110110', '0001011', '0000']",23,10,13,0.4347826086956521,0.5652173913043478,4,5,0.9876925088958034,1
"['1111011', '010010', '101100']",19,11,8,0.5789473684210527,0.4210526315789473,4,2,0.9819407868640976,1
"['111110', '101', '00010', '001', '001']",20,10,10,0.5,0.5,2,3,1.0,1
"['0100', '10', '0101110', '1001000', '1001', '10011', '00']",31,13,18,0.4193548387096774,0.5806451612903226,3,7,0.9811522341999132,0
"['00010', '111010', '0', '11100']",17,8,9,0.4705882352941176,0.5294117647058824,2,3,0.9975025463691152,1
"['110101', '10', '0', '011', '1001000', '1010', '0', '0111']",28,14,14,0.5,0.5,4,4,1.0,0
"['011', '110000', '1001', '1']",14,7,7,0.5,0.5,3,3,1.0,1
"['1011010', '10']",9,5,4,0.5555555555555556,0.4444444444444444,1,0,0.9910760598382222,1
"['01', '011', '0', '10', '0', '1010000', '1100011', '00']",25,10,15,0.4,0.6,3,5,0.9709505944546686,0
"['0011001', '01', '0000111', '11', '110101', '1000111', '101001']",37,20,17,0.5405405405405406,0.4594594594594595,7,6,0.9952525494396792,0
"['111010', '0000111', '01']",15,8,7,0.5333333333333333,0.4666666666666667,2,2,0.9967916319816366,1
"['00', '0001', '10010']",11,3,8,0.2727272727272727,0.7272727272727273,1,3,0.8453509366224364,1
"['000', '01', '01110', '001', '1010', '0']",18,7,11,0.3888888888888889,0.6111111111111112,2,4,0.964078764808229,0
['1101011'],7,5,2,0.7142857142857143,0.2857142857142857,2,0,0.863120568566631,1
"['0000101', '010', '0', '00', '1', '0', '110010', '00', '10001', '101']",31,11,20,0.3548387096774194,0.6451612903225806,2,7,0.9383153522334068,0
"['1101', '1010']",8,5,3,0.625,0.375,2,0,0.954434002924965,1
"['1111', '10011', '1110']",13,10,3,0.7692307692307693,0.2307692307692307,4,1,0.7793498372920851,1
"['0', '1', '010100', '111100', '111000', '1101011', '1', '11111']",33,21,12,0.6363636363636364,0.3636363636363636,8,3,0.94566030460064,0
"['010000', '0111001', '10', '000011', '000010', '00', '10', '01000', '0110000']",43,13,30,0.3023255813953488,0.6976744186046512,4,13,0.8841151220488479,0
"['1', '111', '1', '1001010', '11', '101', '1111000', '1']",25,17,8,0.68,0.32,6,2,0.9043814577244936,0
"['11', '0', '010100']",9,4,5,0.4444444444444444,0.5555555555555556,1,2,0.9910760598382222,1
['101000'],6,2,4,0.3333333333333333,0.6666666666666666,0,1,0.9182958340544896,1
"['1010000', '00000', '1110001', '00101', '1', '011001', '0011111', '101', '100001']",47,21,26,0.4468085106382978,0.5531914893617021,7,10,0.9918207974218424,0
"['00111', '0', '0100', '1110', '100', '0', '0010']",22,9,13,0.4090909090909091,0.5909090909090909,2,5,0.9760206482366148,0
"['011110', '101010', '1111', '1', '010111', '1', '010', '01']",29,19,10,0.6551724137931034,0.3448275862068966,6,1,0.9293636260137188,0
"['0010111', '001', '0000', '01', '0111', '0', '1']",22,10,12,0.4545454545454545,0.5454545454545454,2,4,0.9940302114769564,0
"['000', '010000', '10011', '111', '001011', '10110']",28,13,15,0.4642857142857143,0.5357142857142857,4,6,0.996316519558962,1
"['100', '01101', '1']",9,5,4,0.5555555555555556,0.4444444444444444,2,1,0.9910760598382222,1
"['1', '01', '001001', '0', '1101', '011001', '10000', '00110', '110', '01']",35,16,19,0.4571428571428571,0.5428571428571428,5,7,0.9946937953613058,0
"['10101', '0101']",9,5,4,0.5555555555555556,0.4444444444444444,0,0,0.9910760598382222,1
['1111101'],7,6,1,0.8571428571428571,0.1428571428571428,2,0,0.5916727785823275,1
['010001'],6,2,4,0.3333333333333333,0.6666666666666666,0,1,0.9182958340544896,1
"['1101', '111110', '0000110']",17,10,7,0.5882352941176471,0.4117647058823529,5,2,0.9774178175281716,1
"['1', '01', '111', '0', '0010', '10100', '100001', '0100001']",29,12,17,0.4137931034482758,0.5862068965517241,2,6,0.9784493292686188,0
"['00', '101', '11', '111', '111', '001111', '1', '010111', '001111', '11011']",37,27,10,0.7297297297297297,0.2702702702702703,11,3,0.8418521897563207,0
['10'],2,1,1,0.5,0.5,0,0,1.0,1
"['110100', '1101', '00', '11010', '1', '0', '001110', '0', '1', '0']",28,14,14,0.5,0.5,4,4,1.0,0
"['10101', '010110']",11,6,5,0.5454545454545454,0.4545454545454545,1,0,0.9940302114769564,1
"['00', '1', '1', '11001']",9,5,4,0.5555555555555556,0.4444444444444444,2,2,0.9910760598382222,0
['1'],1,1,0,1.0,0.0,0,0,-0.0,1
"['110110', '101']",9,6,3,0.6666666666666666,0.3333333333333333,2,0,0.9182958340544896,1
['100'],3,1,2,0.3333333333333333,0.6666666666666666,0,1,0.9182958340544896,1
"['1', '101', '1', '1111101', '00110', '10', '010', '1011001']",29,18,11,0.6206896551724138,0.3793103448275862,6,3,0.9575534837147482,0
"['0011111', '1', '1110', '01111']",17,13,4,0.7647058823529411,0.2352941176470588,6,2,0.7871265862012691,0
"['101111', '00101', '000', '110']",17,9,8,0.5294117647058824,0.4705882352941176,3,2,0.9975025463691152,1
"['111', '0', '1000001', '01000', '0011111', '1111', '1011100', '10100', '000010']",45,22,23,0.4888888888888889,0.5111111111111111,7,8,0.999643749677856,0
"['101111', '0100', '1110000', '1111001', '1001101', '0001100']",38,20,18,0.5263157894736842,0.4736842105263157,8,7,0.9980008838722996,1
"['0111', '0', '10000', '10', '000', '1010', '010111']",25,11,14,0.44,0.56,2,5,0.9895875212220556,0
"['110', '0', '0000000', '0', '1', '111', '1111001', '111', '1']",27,15,12,0.5555555555555556,0.4444444444444444,7,6,0.9910760598382222,0
"['1', '1000100', '100', '10111']",16,8,8,0.5,0.5,2,3,1.0,1
"['0010010', '010', '111', '0100', '10', '100111']",25,12,13,0.48,0.52,2,5,0.9988455359952018,0
"['1', '00010', '11100', '11', '0010000', '111', '1001', '100011', '11110', '0110000']",45,22,23,0.4888888888888889,0.5111111111111111,9,10,0.999643749677856,0
"['0', '011100', '10101', '1111111', '0001000', '001', '0', '00']",32,15,17,0.46875,0.53125,5,6,0.9971803988942642,0
"['11', '011100', '0010']",12,6,6,0.5,0.5,2,2,1.0,1
"['1001', '1', '1000010', '0', '110']",16,7,9,0.4375,0.5625,2,4,0.9886994082884974,0
"['100', '11', '101001', '1', '1110']",16,10,6,0.625,0.375,3,2,0.954434002924965,0
"['10', '1', '010', '010001', '10011']",17,8,9,0.4705882352941176,0.5294117647058824,2,3,0.9975025463691152,0
"['0111', '1000011', '0001010', '00101', '011111']",29,15,14,0.5172413793103449,0.4827586206896552,5,4,0.9991421039919088,1
"['101100', '010', '110011', '0000000', '110', '01', '1100011', '0111000']",41,18,23,0.4390243902439024,0.5609756097560976,7,8,0.9892452969285004,1
"['110111', '0100101', '10', '10010', '001111', '01000', '0', '0111', '1', '0101101']",44,24,20,0.5454545454545454,0.4545454545454545,8,5,0.9940302114769564,0
"['0011', '10001', '0110110']",16,8,8,0.5,0.5,3,2,1.0,1
"['010', '10', '00', '11', '100010', '101']",18,8,10,0.4444444444444444,0.5555555555555556,1,2,0.9910760598382222,0
"['1100', '1010001', '00', '011010', '1110']",23,11,12,0.4782608695652174,0.5217391304347826,3,3,0.9986359641585718,1
"['0110000', '001', '001110', '0', '10010', '01']",24,9,15,0.375,0.625,2,7,0.954434002924965,0
"['0', '001000', '11', '00001']",14,4,10,0.2857142857142857,0.7142857142857143,1,4,0.863120568566631,0
"['11', '0000110', '000000']",15,4,11,0.2666666666666666,0.7333333333333333,2,5,0.8366407419411672,1
"['10', '1111', '1', '10011', '10111', '1100', '0']",22,15,7,0.6818181818181818,0.3181818181818182,6,2,0.9023932827949788,0
"['010', '011']",6,3,3,0.5,0.5,1,1,1.0,1
"['10111', '01001', '10001', '010', '010', '11', '0001110', '00', '101', '001111']",41,21,20,0.5121951219512195,0.4878048780487805,6,6,0.9995708393473224,0
"['1110', '100']",7,4,3,0.5714285714285714,0.4285714285714285,1,1,0.9852281360342516,1
"['1', '11010', '1010', '11010']",15,9,6,0.6,0.4,2,0,0.9709505944546686,0
['0'],1,0,1,0.0,1.0,0,0,-0.0,1
"['01100', '1100', '1010', '0010', '1', '11110', '00', '0', '0']",27,12,15,0.4444444444444444,0.5555555555555556,4,5,0.9910760598382222,0
"['101', '1001', '01011']",12,7,5,0.5833333333333334,0.4166666666666667,2,1,0.9798687566511528,1
"['111101', '000111']",12,8,4,0.6666666666666666,0.3333333333333333,3,1,0.9182958340544896,1
"['0001101', '10', '00', '010001', '10001', '11101', '10110', '11011', '001', '1001101']",47,24,23,0.5106382978723404,0.4893617021276595,11,7,0.9996734260048916,0
"['0', '11000', '01110', '0011', '0110100', '1111', '1010', '10', '1100111']",39,22,17,0.5641025641025641,0.4358974358974359,8,5,0.98811083652183,0
"['10', '0', '001']",6,2,4,0.3333333333333333,0.6666666666666666,0,2,0.9182958340544896,0
"['0110', '01', '101', '0101', '1111', '010', '010011', '0110']",30,17,13,0.5666666666666667,0.4333333333333333,6,3,0.9871377743721864,0
"['10000', '1101000', '0011', '0100', '10', '110011', '11', '001000']",36,15,21,0.4166666666666667,0.5833333333333334,5,8,0.9798687566511528,0
"['1', '11001', '110', '000', '00', '0111', '111111', '00']",26,15,11,0.5769230769230769,0.4230769230769231,6,5,0.9828586897127056,0
"['00', '110', '1100100', '010', '0', '0100100', '101011', '010', '1']",33,14,19,0.4242424242424242,0.5757575757575758,3,6,0.9833761901392236,0
"['1111', '1111', '01100']",13,10,3,0.7692307692307693,0.2307692307692307,5,1,0.7793498372920851,1
"['0111', '1']",5,4,1,0.8,0.2,2,0,0.7219280948873623,1
"['010001', '1010', '1000000', '1000', '0', '1010100']",29,9,20,0.3103448275862069,0.6896551724137931,1,7,0.8935711016541907,0
['00'],2,0,2,0.0,1.0,0,1,-0.0,1
"['0', '1000', '10', '111', '10101', '01111', '11101', '1101011']",32,21,11,0.65625,0.34375,7,1,0.9283620723948676,0
"['0000010', '01111', '10010', '0110000', '01', '1', '11', '01', '01010', '1111']",40,20,20,0.5,0.5,7,7,1.0,0
"['000', '0', '010', '010110', '01100']",18,6,12,0.3333333333333333,0.6666666666666666,2,5,0.9182958340544896,0
"['1', '1111000', '00010', '111101', '101110', '111110', '0', '01']",34,21,13,0.6176470588235294,0.3823529411764705,8,4,0.9596868937742168,0
"['111', '00111', '0111', '000111', '00', '1', '111100']",27,17,10,0.6296296296296297,0.3703703703703703,6,4,0.9509560484549724,0
['010010'],6,2,4,0.3333333333333333,0.6666666666666666,0,1,0.9182958340544896,1
"['1100', '11', '1', '100010', '11111', '1001', '0', '001001']",29,16,13,0.5517241379310345,0.4482758620689655,6,5,0.9922666387194964,0
"['0', '1', '00', '1', '111001', '11']",13,8,5,0.6153846153846154,0.3846153846153846,3,2,0.961236604722876,0
"['1001', '0111100', '0001', '1', '01111', '0111010', '01000']",33,17,16,0.5151515151515151,0.4848484848484848,6,5,0.9993375041688848,0
"['101', '10', '110', '110110', '101101', '1', '1100101', '01000']",33,19,14,0.5757575757575758,0.4242424242424242,7,2,0.9833761901392236,0
"['11', '001010', '011010', '10001']",19,9,10,0.4736842105263157,0.5263157894736842,2,3,0.9980008838722996,1
"['011', '1', '1', '01', '1011011', '111011', '1110', '11011', '1101000']",36,25,11,0.6944444444444444,0.3055555555555556,11,1,0.8879763195151349,0
"['11', '011', '0011']",9,6,3,0.6666666666666666,0.3333333333333333,3,1,0.9182958340544896,1
['10011'],5,3,2,0.6,0.4,1,1,0.9709505944546686,1
['000110'],6,2,4,0.3333333333333333,0.6666666666666666,1,1,0.9182958340544896,1
"['11', '01001', '101011', '00', '00100']",20,9,11,0.45,0.55,3,4,0.9927744539878084,1
['1'],1,1,0,1.0,0.0,0,0,-0.0,1
"['0110001', '110']",10,5,5,0.5,0.5,2,1,1.0,1
"['01100', '001', '101', '1', '11011', '1', '010', '0100', '0110', '010']",32,16,16,0.5,0.5,6,5,1.0,0
"['10010', '1', '011', '1011110', '011', '100100', '11', '000', '1111', '1010']",38,22,16,0.5789473684210527,0.4210526315789473,7,5,0.9819407868640976,0
"['0001', '010', '011100', '0011111', '111001', '1010', '000010', '1111']",40,21,19,0.525,0.475,8,7,0.99819587904281,1
['1110'],4,3,1,0.75,0.25,1,0,0.8112781244591328,1
"['11101', '110', '0', '100', '0', '0000001', '101']",23,10,13,0.4347826086956521,0.5652173913043478,3,5,0.9876925088958034,0
"['1100', '010', '100000', '1']",14,5,9,0.3571428571428571,0.6428571428571429,1,3,0.9402859586706313,1
"['1101', '101010', '011', '1', '00', '00', '111101', '0001001', '0111011']",38,21,17,0.5526315789473685,0.4473684210526316,7,5,0.9919924034538556,0
"['00', '1001', '0']",7,2,5,0.2857142857142857,0.7142857142857143,0,2,0.863120568566631,0
"['01001', '11', '1', '11']",10,7,3,0.7,0.3,3,1,0.8812908992306927,0
"['1', '1', '011001', '100010', '0', '10000', '11', '0', '101']",26,12,14,0.4615384615384615,0.5384615384615384,4,5,0.9957274520849256,0
"['01', '1010000', '00', '0', '001', '10110', '01', '1']",23,9,14,0.391304347826087,0.6086956521739131,4,5,0.9656361333706098,0
"['11110', '10', '1000', '0001', '011010', '00', '1101110', '0']",31,15,16,0.4838709677419355,0.5161290322580645,5,5,0.9992492479956564,0
"['111', '10', '0010001', '01', '00100', '0110', '1']",24,11,13,0.4583333333333333,0.5416666666666666,3,4,0.99498482818597,0
"['00111', '01010']",10,5,5,0.5,0.5,1,1,1.0,1
"['110111', '01001', '11', '01', '0111', '01', '0', '001', '1110110']",32,20,12,0.625,0.375,7,2,0.954434002924965,0
"['1101111', '1011011', '0', '01']",17,12,5,0.7058823529411765,0.2941176470588235,5,1,0.8739810481273578,1
"['10', '101', '0001001', '1001', '00100']",21,8,13,0.3809523809523809,0.6190476190476191,1,5,0.9587118829771318,1
['111'],3,3,0,1.0,0.0,1,0,-0.0,1
"['101', '00', '1101101']",12,7,5,0.5833333333333334,0.4166666666666667,2,1,0.9798687566511528,1
"['11', '10011', '010', '010', '1011011', '101011', '011100']",32,19,13,0.59375,0.40625,6,3,0.9744894033980523,1
"['1000110', '01']",9,4,5,0.4444444444444444,0.5555555555555556,1,2,0.9910760598382222,1
"['01', '1011', '1101', '10', '100011', '1111101', '01', '111']",30,21,9,0.7,0.3,9,1,0.8812908992306927,0
"['1', '00100', '0101001', '1111110', '1', '1111', '1101101', '01', '0010010']",41,24,17,0.5853658536585366,0.4146341463414634,7,5,0.9788698505067784,0
"['0011', '001000', '011111', '1', '0', '1111010', '000', '0101011', '001']",38,19,19,0.5,0.5,7,7,1.0,0
"['111', '00', '0', '1100', '0001', '010000', '1110000', '0110', '1']",32,13,19,0.40625,0.59375,4,7,0.9744894033980523,0
"['101', '00', '100', '11001', '011', '011100', '01101', '0011111', '0110100', '100010']",47,24,23,0.5106382978723404,0.4893617021276595,7,7,0.9996734260048916,0
['11001'],5,3,2,0.6,0.4,1,1,0.9709505944546686,1
"['1', '01', '0100', '100', '0', '0000']",15,4,11,0.2666666666666666,0.7333333333333333,0,4,0.8366407419411672,0
"['0001', '0000010', '001', '00', '100000', '00', '11010']",29,7,22,0.2413793103448276,0.7586206896551724,1,8,0.7973265101474423,0
"['01', '00110', '1010011', '0', '0', '10011']",21,10,11,0.4761904761904761,0.5238095238095238,3,4,0.998363672593813,0
"['00', '101100', '0111', '1', '001', '01', '0010110', '0']",26,12,14,0.4615384615384615,0.5384615384615384,4,5,0.9957274520849256,0
"['1', '00', '0110', '101']",10,5,5,0.5,0.5,1,1,1.0,0
"['0', '0100', '1001', '10001', '1100', '0101100', '1110', '111', '1100', '1']",37,19,18,0.5135135135135135,0.4864864864864865,6,7,0.9994730201859836,0
"['011101', '001000', '00011']",17,7,10,0.4117647058823529,0.5882352941176471,2,4,0.9774178175281716,1
"['011001', '0101001', '10010', '0', '1']",20,9,11,0.45,0.55,2,4,0.9927744539878084,0
"['0011001', '110', '00011', '000', '111001', '101', '1110110', '00', '0', '10']",39,19,20,0.4871794871794871,0.5128205128205128,8,8,0.999525689293649,0
"['00', '1100111', '10', '1010', '100', '0010011', '1000', '101', '010011', '10']",40,19,21,0.475,0.525,5,7,0.99819587904281,0
"['1110', '010', '00', '101', '1001010', '0010100', '11101', '1001010']",38,18,20,0.4736842105263157,0.5263157894736842,4,6,0.9980008838722996,0
"['11001', '010']",8,4,4,0.5,0.5,1,1,1.0,1
"['0000', '0001101', '10111', '0011', '10', '110', '111', '0001']",32,16,16,0.5,0.5,6,5,1.0,0
['01'],2,1,1,0.5,0.5,0,0,1.0,1
"['000011', '1011111', '0000', '000', '1', '1010']",25,11,14,0.44,0.56,4,5,0.9895875212220556,0
"['11', '100', '001100', '0110010', '0100', '01101', '000']",30,12,18,0.4,0.6,4,7,0.9709505944546686,1
['0011100'],7,3,4,0.4285714285714285,0.5714285714285714,1,2,0.9852281360342516,1
"['000', '111110', '11000', '0001111', '0110101', '0110', '100', '1101']",39,21,18,0.5384615384615384,0.4615384615384615,8,5,0.9957274520849256,1
"['1', '0000']",5,1,4,0.2,0.8,0,2,0.7219280948873623,1
['001'],3,1,2,0.3333333333333333,0.6666666666666666,0,1,0.9182958340544896,1
"['000101', '0011101', '0', '0']",15,6,9,0.4,0.6,1,3,0.9709505944546686,1
"['11101', '0000000']",12,4,8,0.3333333333333333,0.6666666666666666,1,3,0.9182958340544896,1
"['00100', '1111', '00011']",14,7,7,0.5,0.5,3,3,1.0,1
"['0', '1000111', '1', '001', '01101', '00', '0101', '1', '010', '11111']",32,18,14,0.5625,0.4375,6,3,0.9886994082884974,0
"['0101101', '1', '1001', '01010', '101010', '1100101', '0101', '1010', '0100']",42,21,21,0.5,0.5,4,4,1.0,0
"['0101110', '1100010', '001', '110', '1011', '101']",27,15,12,0.5555555555555556,0.4444444444444444,4,2,0.9910760598382222,0
"['0010', '101', '11', '1011', '11', '11000']",20,12,8,0.6,0.4,5,2,0.9709505944546686,1
"['010', '011110', '0', '010']",13,6,7,0.4615384615384615,0.5384615384615384,2,2,0.9957274520849256,1
"['111010', '0110111', '0110111', '0110', '101101']",30,20,10,0.6666666666666666,0.3333333333333333,7,1,0.9182958340544896,1
"['10', '000000', '010110']",14,4,10,0.2857142857142857,0.7142857142857143,1,4,0.863120568566631,1
['01'],2,1,1,0.5,0.5,0,0,1.0,1
"['101', '0111', '101', '01', '0100111', '0000000', '0000', '11', '001', '1110100']",42,19,23,0.4523809523809524,0.5476190476190477,6,8,0.9934472383802028,0
"['00', '011', '101', '100111', '10001']",19,10,9,0.5263157894736842,0.4736842105263157,4,3,0.9980008838722996,1
['01111'],5,4,1,0.8,0.2,2,0,0.7219280948873623,1
"['1101100', '11010', '11', '100', '111', '0', '10101', '101', '101101']",35,22,13,0.6285714285714286,0.3714285714285714,8,2,0.9517626756348312,0
"['010', '1100011', '1000101', '11000', '11101', '0', '100001', '11000']",39,18,21,0.4615384615384615,0.5384615384615384,5,6,0.9957274520849256,0
"['00', '101010']",8,3,5,0.375,0.625,0,1,0.954434002924965,1
['111100'],6,4,2,0.6666666666666666,0.3333333333333333,2,1,0.9182958340544896,1
"['0', '1011', '1101010', '0', '11101', '1100', '111110']",28,18,10,0.6428571428571429,0.3571428571428571,6,2,0.9402859586706313,1
"['000', '001', '11110', '01100', '111000']",22,10,12,0.4545454545454545,0.5454545454545454,4,5,0.9940302114769564,1
"['1010', '0', '11100', '101100', '0', '1010', '1', '0010000']",29,12,17,0.4137931034482758,0.5862068965517241,2,6,0.9784493292686188,0
"['1100001', '100', '01', '1', '0100101', '0101', '0010010']",31,13,18,0.4193548387096774,0.5806451612903226,3,6,0.9811522341999132,0
"['1011', '01']",6,4,2,0.6666666666666666,0.3333333333333333,1,0,0.9182958340544896,1
"['1', '11', '0111011', '1', '101', '101011', '100001', '1', '000']",30,18,12,0.6,0.4,7,3,0.9709505944546686,0
"['1001001', '1000', '10', '0']",14,5,9,0.3571428571428571,0.6428571428571429,1,4,0.9402859586706313,0
"['11110', '1', '101100', '10101', '1111', '0010', '1111']",29,20,9,0.6896551724137931,0.3103448275862069,8,2,0.8935711016541907,0
"['0101', '0', '01010', '01101', '0000011', '1', '1', '00', '1', '010']",30,13,17,0.4333333333333333,0.5666666666666667,3,5,0.9871377743721864,0
"['01100', '01010', '1100', '10', '0011', '00011', '110', '0001', '0', '00110']",38,16,22,0.4210526315789473,0.5789473684210527,6,7,0.9819407868640976,0
"['0111', '0110010', '010', '100111', '01101', '111', '11011', '110', '00']",38,23,15,0.6052631578947368,0.3947368421052631,9,4,0.9677884628267678,0
"['1', '10111', '0', '10', '010']",12,7,5,0.5833333333333334,0.4166666666666667,2,1,0.9798687566511528,0
"['101100', '1111000', '1', '010', '101110', '10', '000', '0', '000']",32,14,18,0.4375,0.5625,4,6,0.9886994082884974,0
"['0111', '1010000', '0110110', '1010', '011']",25,13,12,0.52,0.48,5,3,0.9988455359952018,1
"['11', '0', '11', '00100']",10,5,5,0.5,0.5,2,2,1.0,1
"['01001', '0011010', '010001', '0100', '10', '110', '0']",28,11,17,0.3928571428571428,0.6071428571428571,2,6,0.9666186325481028,0
"['101110', '10001']",11,6,5,0.5454545454545454,0.4545454545454545,1,1,0.9940302114769564,1
"['0100111', '000', '0', '0010', '0', '0', '1001', '00010']",26,8,18,0.3076923076923077,0.6923076923076923,1,7,0.8904916402194913,0
"['0111001', '0001', '10', '0', '110010', '10111', '1000', '0000100']",36,15,21,0.4166666666666667,0.5833333333333334,5,8,0.9798687566511528,0
"['00101', '011111']",11,7,4,0.6363636363636364,0.3636363636363636,2,1,0.94566030460064,1
"['01110', '0100', '0', '1001101']",17,8,9,0.4705882352941176,0.5294117647058824,2,3,0.9975025463691152,1
"['01', '111', '110', '0110', '1000000', '011001', '1011', '00', '01', '001001']",39,18,21,0.4615384615384615,0.5384615384615384,7,8,0.9957274520849256,0
"['00', '0010011', '11', '11001', '0101011', '0001001', '11', '1']",33,17,16,0.5151515151515151,0.4848484848484848,6,6,0.9993375041688848,0
"['0110100', '0101', '01000', '0011101']",23,10,13,0.4347826086956521,0.5652173913043478,2,3,0.9876925088958034,1
"['000', '0100', '01001', '111101', '011', '01', '01', '101001', '111001']",37,19,18,0.5135135135135135,0.4864864864864865,6,6,0.9994730201859836,0
"['011100', '00', '0001', '0110', '11000']",21,8,13,0.3809523809523809,0.6190476190476191,3,4,0.9587118829771318,0
"['1001', '010010', '01', '010011', '1', '000110', '11']",27,13,14,0.4814814814814814,0.5185185185185185,3,5,0.9990102708804812,0
"['0', '1111011', '0', '0', '10010']",15,8,7,0.5333333333333333,0.4666666666666667,3,2,0.9967916319816366,1
"['00001', '1', '0101', '11010', '011010', '0001101', '11', '1011111', '10010']",42,23,19,0.5476190476190477,0.4523809523809524,9,6,0.9934472383802028,0
"['1', '011', '1001']",8,5,3,0.625,0.375,1,1,0.954434002924965,1
"['1101010', '001', '111', '1001100', '1']",21,12,9,0.5714285714285714,0.4285714285714285,4,3,0.9852281360342516,0
"['1011001', '1000', '10101', '01', '100', '1001111', '101010', '10001', '111', '0001101']",49,26,23,0.5306122448979592,0.4693877551020408,8,6,0.9972943816462349,0
"['1', '0100000', '101', '0', '000']",15,4,11,0.2666666666666666,0.7333333333333333,0,4,0.8366407419411672,0
"['10', '010011', '0', '01', '100']",14,6,8,0.4285714285714285,0.5714285714285714,2,4,0.9852281360342516,0
['01110'],5,3,2,0.6,0.4,1,0,0.9709505944546686,1
"['0101110', '01110', '0', '0', '0000', '1011', '100000', '00', '01']",32,12,20,0.375,0.625,3,8,0.954434002924965,0
"['0', '101011', '01', '01001', '111011', '10001', '100', '10110', '101111', '001100']",45,25,20,0.5555555555555556,0.4444444444444444,9,5,0.9910760598382222,0
"['11', '10101', '00', '1']",10,6,4,0.6,0.4,1,1,0.9709505944546686,0
"['001110', '10', '001', '1', '0001100', '100100']",25,10,15,0.4,0.6,3,6,0.9709505944546686,0
"['1100', '0001', '0010010', '0001111', '1110', '11000']",31,14,17,0.4516129032258064,0.5483870967741935,5,7,0.9932338197397066,1
"['111', '101001', '1', '10100', '00', '01011', '101', '0', '000']",29,14,15,0.4827586206896552,0.5172413793103449,4,5,0.9991421039919088,0
"['0110101', '11', '11010', '01110', '0110', '0000']",27,14,13,0.5185185185185185,0.4814814814814814,5,4,0.9990102708804812,1
"['0', '1', '0001', '10110', '0']",12,5,7,0.4166666666666667,0.5833333333333334,2,2,0.9798687566511528,0
"['1111100', '10101', '0010110', '000000', '0111010']",32,15,17,0.46875,0.53125,4,6,0.9971803988942642,1
['10100'],5,2,3,0.4,0.6,0,1,0.9709505944546686,1
"['010', '1110', '1110101', '0', '10101', '111', '10', '1010', '1']",30,19,11,0.6333333333333333,0.3666666666666666,4,0,0.9480782435939056,0
['0010101'],7,3,4,0.4285714285714285,0.5714285714285714,0,1,0.9852281360342516,1
"['0000011', '1110', '101111', '11']",19,12,7,0.631578947368421,0.3684210526315789,5,2,0.9494520153879484,0
"['0111111', '1', '01', '0010', '11', '1100', '100', '1001', '111']",30,19,11,0.6333333333333333,0.3666666666666666,7,4,0.9480782435939056,0
"['01', '1100000', '10', '0001000']",18,5,13,0.2777777777777778,0.7222222222222222,1,5,0.8524051786494786,1
"['101000', '1', '1000000', '0', '000', '01', '0', '1111010']",28,10,18,0.3571428571428571,0.6428571428571429,3,6,0.9402859586706313,0
"['00000', '10010', '1', '001001', '1100010', '001111', '010000', '1', '000']",40,14,26,0.35,0.65,3,10,0.934068055375491,0
"['011', '1010', '01', '111']",12,8,4,0.6666666666666666,0.3333333333333333,3,1,0.9182958340544896,1
"['10', '011', '00110']",10,5,5,0.5,0.5,2,2,1.0,1
"['10', '11000', '0101', '1', '111011']",18,11,7,0.6111111111111112,0.3888888888888889,4,2,0.964078764808229,0
"['0111110', '000000', '0011000', '111']",23,10,13,0.4347826086956521,0.5652173913043478,4,5,0.9876925088958034,1
"['1', '0000', '011001', '11111', '111101', '011', '0', '00']",28,16,12,0.5714285714285714,0.4285714285714285,7,4,0.9852281360342516,0
"['0101', '0101111', '0111', '1', '1111']",20,15,5,0.75,0.25,6,0,0.8112781244591328,0
"['1111001', '101', '1100010', '1010101', '0001000', '1', '00', '01010']",39,18,21,0.4615384615384615,0.5384615384615384,4,5,0.9957274520849256,0
"['01', '101', '101010', '010', '00', '10000', '001110', '11000', '0000', '0001']",40,14,26,0.35,0.65,4,10,0.934068055375491,0
['1100001'],7,3,4,0.4285714285714285,0.5714285714285714,1,2,0.9852281360342516,1
"['100010', '010110', '000010', '0000']",22,6,16,0.2727272727272727,0.7272727272727273,1,6,0.8453509366224364,1
"['00', '011', '111', '01001', '100011', '00', '1101', '10011', '000']",33,16,17,0.4848484848484848,0.5151515151515151,7,6,0.9993375041688848,0
"['0101010', '1011011', '011010', '110100', '0', '11']",29,16,13,0.5517241379310345,0.4482758620689655,5,1,0.9922666387194964,0
"['01', '000001', '011001', '11', '110', '000', '10', '0', '0', '0101']",30,12,18,0.4,0.6,3,7,0.9709505944546686,0
"['01', '11011', '0']",8,5,3,0.625,0.375,2,0,0.954434002924965,1
['1101'],4,3,1,0.75,0.25,1,0,0.8112781244591328,1
"['000111', '1101000']",13,6,7,0.4615384615384615,0.5384615384615384,2,2,0.9957274520849256,1
['011'],3,2,1,0.6666666666666666,0.3333333333333333,1,0,0.9182958340544896,1
"['000000', '010101', '1001011', '11011', '111000', '00', '0100']",36,15,21,0.4166666666666667,0.5833333333333334,5,8,0.9798687566511528,0
"['0111000', '10', '0001111', '0110', '101', '0110101', '000010']",36,17,19,0.4722222222222222,0.5277777777777778,5,5,0.997772472089982,0
['100'],3,1,2,0.3333333333333333,0.6666666666666666,0,1,0.9182958340544896,1
"['0110', '01', '10', '100000', '001101', '1011110', '11111', '0', '01', '0001100']",42,21,21,0.5,0.5,9,7,1.0,0
"['010', '011', '1000']",10,4,6,0.4,0.6,1,2,0.9709505944546686,1
"['1001100', '101111', '1011']",17,11,6,0.6470588235294118,0.3529411764705882,4,2,0.9366673818775626,1
"['1011011', '11', '10110', '0', '01', '1', '110', '1000']",25,15,10,0.6,0.4,6,2,0.9709505944546686,0
"['000', '110101', '000']",12,4,8,0.3333333333333333,0.6666666666666666,1,2,0.9182958340544896,1
"['010010', '000', '110101', '111']",18,9,9,0.5,0.5,3,3,1.0,1
"['111100', '00000', '10110', '10', '00', '0100', '010']",27,10,17,0.3703703703703703,0.6296296296296297,3,6,0.9509560484549724,0
"['110', '01111']",8,6,2,0.75,0.25,3,1,0.8112781244591328,1
"['11101', '1101010', '11']",14,10,4,0.7142857142857143,0.2857142857142857,3,0,0.863120568566631,1
"['1', '0000', '0', '11', '101010', '0111', '1111111', '00', '010001']",33,18,15,0.5454545454545454,0.4545454545454545,6,5,0.9940302114769564,0
"['01', '1', '10', '100000', '0', '0100', '1100100', '01', '100', '00']",30,10,20,0.3333333333333333,0.6666666666666666,3,8,0.9182958340544896,0
"['01010', '010010', '101001', '00', '00', '1', '10110', '11', '111']",32,16,16,0.5,0.5,4,5,1.0,0
"['0111001', '10', '0', '0100101', '001100', '101100', '0110', '11', '11111', '10']",42,23,19,0.5476190476190477,0.4523809523809524,9,6,0.9934472383802028,0
"['1110', '101', '10', '111111', '0100', '1001010', '010000']",32,17,15,0.53125,0.46875,5,5,0.9971803988942642,0
"['0', '1011100', '1100101', '0110100']",22,11,11,0.5,0.5,3,3,1.0,1
"['11001', '1011', '111111', '001', '10', '11111', '1', '0001', '111101']",36,26,10,0.7222222222222222,0.2777777777777778,12,3,0.8524051786494786,0
"['0011', '101001', '1', '101011', '1', '01100', '0011', '010101', '010']",36,19,17,0.5277777777777778,0.4722222222222222,5,4,0.997772472089982,0
"['00001', '0111', '1101', '00', '111', '000100', '11', '0010111']",33,17,16,0.5151515151515151,0.4848484848484848,5,6,0.9993375041688848,0
['100111'],6,4,2,0.6666666666666666,0.3333333333333333,1,1,0.9182958340544896,1
"['010', '11', '01', '0', '10111', '011']",16,10,6,0.625,0.375,3,0,0.954434002924965,0
"['11', '1110', '01']",8,6,2,0.75,0.25,2,1,0.8112781244591328,1
"['1', '000', '00100', '011111', '110111', '11', '0101', '011001']",33,19,14,0.5757575757575758,0.4242424242424242,6,4,0.9833761901392236,0
"['010011', '111010', '00', '1100000']",21,9,12,0.4285714285714285,0.5714285714285714,3,4,0.9852281360342516,1
"['0110010', '1011000']",14,6,8,0.4285714285714285,0.5714285714285714,2,2,0.9852281360342516,1
"['0', '100111', '1000', '0']",12,5,7,0.4166666666666667,0.5833333333333334,2,3,0.9798687566511528,1
"['1011110', '0111010', '11101']",19,13,6,0.6842105263157895,0.3157894736842105,4,1,0.8997437586982626,1
"['0010111', '010', '11110', '1']",16,10,6,0.625,0.375,3,1,0.954434002924965,0
"['000000', '00010', '101110', '10', '0', '1', '0100', '1']",26,9,17,0.3461538461538461,0.6538461538461539,1,6,0.9305861291319928,0
"['0011', '1010', '11', '10', '11', '0100101', '0000', '01']",27,13,14,0.4814814814814814,0.5185185185185185,3,4,0.9990102708804812,0
"['1001001', '001', '100011', '1']",17,8,9,0.4705882352941176,0.5294117647058824,2,4,0.9975025463691152,0
"['10', '010101', '101', '01', '001', '100', '00100']",24,10,14,0.4166666666666667,0.5833333333333334,2,5,0.9798687566511528,0
"['00000', '00', '1001']",11,2,9,0.1818181818181818,0.8181818181818182,0,4,0.6840384356390417,0
"['01000', '11', '010', '0', '10', '1101010']",20,9,11,0.45,0.55,2,2,0.9927744539878084,0
"['1', '11', '0000', '100111', '010', '011', '10110']",24,13,11,0.5416666666666666,0.4583333333333333,4,4,0.99498482818597,0
"['11111', '1010']",9,7,2,0.7777777777777778,0.2222222222222222,3,0,0.7642045065086203,1
"['0001100', '101011', '0101', '1111', '0000001', '10010']",33,15,18,0.4545454545454545,0.5454545454545454,5,6,0.9940302114769564,1
['00111'],5,3,2,0.6,0.4,1,1,0.9709505944546686,1
"['0101', '1001', '110010', '00111', '010001', '10']",27,13,14,0.4814814814814814,0.5185185185185185,4,4,0.9990102708804812,1
"['1111100', '01010', '10010', '00']",19,9,10,0.4736842105263157,0.5263157894736842,2,3,0.9980008838722996,1
"['00', '011', '01', '10101', '10110', '001', '10111', '000101']",31,16,15,0.5161290322580645,0.4838709677419355,6,3,0.9992492479956564,0
"['10000', '101', '11', '11', '1000', '10']",18,9,9,0.5,0.5,3,3,1.0,1
"['100110', '0100010', '0', '011', '0', '01', '0', '11', '10']",25,11,14,0.44,0.56,3,5,0.9895875212220556,0
"['0', '0110', '0100', '01', '000111', '1110110', '0100', '0111111']",35,19,16,0.5428571428571428,0.4571428571428571,8,6,0.9946937953613058,0
"['011', '010001', '0110']",13,6,7,0.4615384615384615,0.5384615384615384,2,1,0.9957274520849256,1
"['1110100', '11100', '0111']",16,10,6,0.625,0.375,3,2,0.954434002924965,1
"['00', '11', '00011']",9,4,5,0.4444444444444444,0.5555555555555556,2,2,0.9910760598382222,1
"['0000010', '0010', '1100011', '0010', '1001100', '11010', '01', '1011', '010', '1111100']",50,23,27,0.46,0.54,8,9,0.9953784388202256,0
['000110'],6,2,4,0.3333333333333333,0.6666666666666666,1,1,0.9182958340544896,1
"['0', '01', '1011', '0100111', '01110']",19,11,8,0.5789473684210527,0.4210526315789473,4,2,0.9819407868640976,0
"['0010', '111', '0', '00', '000111', '001', '01']",21,9,12,0.4285714285714285,0.5714285714285714,2,5,0.9852281360342516,0
"['101', '0', '1101100', '01', '11011']",18,11,7,0.6111111111111112,0.3888888888888889,4,1,0.964078764808229,0
